amazing = удивительный
bank (money) = банк
birthday = день рождения
climb = взбираться
clock = часы
diet = диета
euro = евро
goodbye = до свидания
have to = должен
hi = привет
ice cream = мороженое
information = информация
join = присоединиться
kind (type) = вид, тип
last (final) = последний
life = жизнь
light (from the sun/a lamp) = свет
like (similar) = как (похожий)
like (find something pleasant) = нравится
match (contest) = матч, соревнование
mile = миля
next to = рядом
nine = девять
no one = никто
onion = лук
quick = быстрый
report = отчет
snake = змея
thousand = тысяча
until = до
video = видео
village = деревня
where = где
which = который
yesterday = вчера
about = о, об
above = выше, над
across = через
action = действие
activity = деятельность
actor = актер
actress = актриса
add = добавить
address = адрес
adult = взрослый
advice = совет
afraid = бояться
after = после
afternoon = после обеда
again = снова
age = возраст
ago = назад
agree = согласиться
air = воздух
airport = аэропорт
all = все
also = также
always = всегда
and = и
angry = злой
animal = животное
another = другой
answer = ответ
any = любой
anyone = кто угодно
anything = что угодно
apartment = квартира
apple = яблоко
April = апрель
area = область, район
arm = рука
around = вокруг
arrive = прибывать
art = искусство
article = статья
artist = художник, артист
as = как, в качестве
ask = спросить
at = у, в
August = август
aunt = тетя
autumn = осень
away = далеко
baby = малыш
back = назад
bad = плохой
bag = сумка
ball = мяч
banana = банан
band = группа
bath = ванна
bathroom = ванная комната
be = быть
beach = пляж
beautiful = красивый
because = потому что
become = стать
bed = кровать
bedroom = спальня
beer = пиво
before = перед, до
begin = начинать
beginning = начало
behind = за, позади
believe = верить
below = ниже
best = лучший
better = лучше
between = между
bicycle = велосипед
big = большой
bike = велосипед
bill = счет
bird = птица
black = черный
blog = блог
blonde = блондинка
blue = синий
boat = лодка
body = тело
book = книга
boot = ботинок
bored = скучающий
boring = скучный
born = родиться
both = оба
bottle = бутылка
box = коробка
boy = мальчик
boyfriend = парень
bread = хлеб
break = перерыв, ломать
breakfast = завтрак
bring = приносить
brother = брат
brown = коричневый
build = строить
building = здание
bus = автобус
business = бизнес
busy = занятой
but = но
butter = масло
buy = покупать
by = у, рядом, посредством
bye = пока
cafe = кафе
cake = торт
call = звонить, называть
camera = камера
can = мочь
cannot = не могу
capital = столица
car = машина
card = карта
career = карьера
carrot = морковь
carry = нести
cat = кот
CD = компакт-диск
cent = цент
centre = центр
century = век
chair = стул
change = менять
chart = таблица
cheap = дешевый
check = проверять
cheese = сыр
chicken = курица
child = ребенок
chocolate = шоколад
choose = выбирать
cinema = кинотеатр
city = город
class = класс
classroom = классная комната
clean = чистый
close = закрывать
clothes = одежда
club = клуб
coat = пальто
coffee = кофе
cold = холодный
college = колледж
colour = цвет
come = приходить
common = общий
company = компания
compare = сравнивать
complete = завершать
computer = компьютер
concert = концерт
conversation = разговор
cook = готовить
cooking = кулинария
cool = классный
correct = правильный
cost = стоить
could = мог
country = страна
course = курс
cousin = двоюродный брат/сестра
cow = корова
cream = крем, сливки
create = создавать
culture = культура
cup = чашка
customer = клиент
cut = резать
dad = папа
dance = танцевать
dancer = танцор
dancing = танцы
dangerous = опасный
dark = темный
date = дата, свидание
daughter = дочь
day = день
dear = дорогой
December = декабрь
decide = решать
delicious = вкусный
describe = описывать
description = описание
design = дизайн
desk = письменный стол
detail = деталь
dialogue = диалог
dictionary = словарь
die = умирать
difference = разница
different = разный
difficult = трудный
dinner = ужин
dirty = грязный
discuss = обсуждать
dish = блюдо
do = делать
doctor = врач
dog = собака
dollar = доллар
door = дверь
down = вниз
downstairs = вниз по лестнице
draw = рисовать
dress = платье
drink = пить
drive = водить
driver = водитель
during = во время
DVD = DVD-диск
each = каждый
ear = ухо
early = ранний
east = восток
easy = легкий
eat = есть
egg = яйцо
eight = восемь
eighteen = восемнадцать
eighty = восемьдесят
elephant = слон
eleven = одиннадцать
else = ещё
email = электронная почта
end = конец
enjoy = наслаждаться
enough = достаточно
even = даже
evening = вечер
event = событие
ever = когда-либо
every = каждый
everybody = все
everyone = каждый
everything = всё
exam = экзамен
example = пример
excited = взволнованный
exciting = захватывающий
exercise = упражнение
expensive = дорогой
explain = объяснять
extra = дополнительный
eye = глаз
face = лицо
fact = факт
fall = падать
false = ложный
family = семья
famous = знаменитый
fantastic = фантастический
far = далеко
farm = ферма
farmer = фермер
fast = быстрый
fat = толстый
father = отец
favourite = любимый
February = февраль
feel = чувствовать
feeling = чувство
festival = фестиваль
few = несколько
fifteen = пятнадцать
fifth = пятый
fifty = пятьдесят
fill = наполнять
film = фильм
final = финал, окончательный
find = находить
fine = хороший
finish = заканчивать
fire = огонь
first = первый
fish = рыба
five = пять
flat = квартира
flight = полет
floor = пол
flower = цветок
fly = летать
follow = следовать
food = еда
foot = нога
football = футбол
for = для
forget = забывать
form = форма
forty = сорок
four = четыре
fourteen = четырнадцать
fourth = четвертый
free = свободный
Friday = пятница
friend = друг
friendly = дружелюбный
from = из
front = передняя часть
fruit = фрукт
full = полный
fun = веселье
funny = смешной
future = будущее
game = игра
garden = сад
geography = география
get = получать
girl = девочка
girlfriend = девушка
give = давать
glass = стакан
go = идти
good = хороший
grandfather = дедушка
grandmother = бабушка
grandparent = дедушка или бабушка
great = великий
green = зеленый
grey = серый
group = группа
grow = расти
guess = догадываться
guitar = гитара
gym = спортзал
hair = волосы
half = половина
hand = рука
happen = случаться
happy = счастливый
hard = трудный
hat = шляпа
hate = ненавидеть
have = иметь
he = он
head = голова
health = здоровье
healthy = здоровый
hear = слышать
hello = здравствуй
help = помогать
her = её
here = здесь
hey = эй
high = высокий
him = его
his = его
history = история
hobby = хобби
holiday = праздник
home = дом
homework = домашнее задание
hope = надеяться
horse = лошадь
hospital = больница
hot = горячий
hotel = отель
hour = час
house = дом
how = как
however = однако
hundred = сто
hungry = голодный
husband = муж
ice = лед
idea = идея
if = если
imagine = представлять
important = важный
improve = улучшать
in = в
include = включать
interest = интерес
interested = заинтересованный
interesting = интересный
internet = интернет
interview = интервью
into = в (внутрь)
introduce = представлять
island = остров
it = это
its = его/её
jacket = куртка
January = январь
jeans = джинсы
job = работа
journey = путешествие
juice = сок
July = июль
June = июнь
just = просто
keep = держать
key = ключ
kilometre = километр
kitchen = кухня
know = знать
land = земля
language = язык
large = большой
late = поздно
later = позже
laugh = смеяться
learn = учиться
leave = покидать
left = налево
leg = нога
lesson = урок
let = позволять
letter = письмо
library = библиотека
lie = лежать
line = линия
lion = лев
list = список
listen = слушать
little = маленький
live = жить
local = местный
long = длинный
look = смотреть
lose = терять
lot = много
love = любовь
lunch = обед
machine = машина
magazine = журнал
main = главный
make = делать
man = мужчина
many = много
map = карта
March = март
market = рынок
married = женатый/замужняя
May = май
maybe = возможно
me = мне
meal = еда
mean = означать
meaning = значение
meat = мясо
meet = встречать
meeting = встреча
member = участник
menu = меню
message = сообщение
metre = метр
midnight = полночь
milk = молоко
million = миллион
minute = минута
miss = скучать
mistake = ошибка
model = модель
modern = современный
moment = момент
Monday = понедельник
money = деньги
month = месяц
more = больше
morning = утро
most = большинство
mother = мать
mountain = гора
mouse = мышь
mouth = рот
move = двигаться
movie = фильм
much = много
mum = мама
museum = музей
music = музыка
must = должен
my = мой
name = имя
natural = естественный
near = рядом
need = нуждаться
negative = отрицательный
neighbour = сосед
never = никогда
new = новый
news = новости
newspaper = газета
next = следующий
nice = приятный
night = ночь
nineteen = девятнадцать
ninety = девяносто
no = нет
nobody = никто
north = север
nose = нос
not = не
note = заметка
nothing = ничего
November = ноябрь
now = сейчас
number = номер, число
nurse = медсестра
object = объект
o'clock = часов
October = октябрь
of = из, о
off = выключено, от
office = офис
often = часто
oh = ох
OK = хорошо
old = старый
on = на
once = однажды
one = один
online = в интернете
only = только
open = открытый
opinion = мнение
opposite = напротив
or = или
orange = апельсин, оранжевый
order = заказывать
other = другой
our = наш
out = вне
outside = снаружи
over = над
own = собственный
page = страница
paint = красить
painting = картина
pair = пара
paper = бумага
paragraph = абзац
parent = родитель
park = парк
part = часть
partner = партнер
party = вечеринка
passport = паспорт
past = прошлое
pay = платить
pen = ручка
pencil = карандаш
people = люди
pepper = перец
perfect = совершенный
period = период
person = человек
personal = личный
phone = телефон
photo = фото
photograph = фотография
phrase = фраза
piano = пианино
picture = картина, изображение
piece = кусок
pig = свинья
pink = розовый
place = место
plan = план
plane = самолет
plant = растение
play = играть
player = игрок
please = пожалуйста
point = точка, указывать
police = полиция
policeman = полицейский
pool = бассейн
poor = бедный
popular = популярный
positive = положительный
possible = возможный
post = почта
potato = картофель
pound = фунт
practice = практика
practise = практиковать
prefer = предпочитать
prepare = готовить
present = подарок, настоящее
pretty = симпатичный
price = цена
probably = вероятно
problem = проблема
product = продукт
programme = программа
project = проект
purple = фиолетовый
put = класть
quarter = четверть
question = вопрос
quickly = быстро
quiet = тихий
quite = довольно
radio = радио
rain = дождь
read = читать
reader = читатель
reading = чтение
ready = готовый
real = реальный
really = действительно
reason = причина
red = красный
relax = расслабляться
remember = помнить
repeat = повторять
restaurant = ресторан
result = результат
return = возвращаться
rice = рис
rich = богатый
ride = ездить
right = правильный, право
river = река
road = дорога
room = комната
routine = рутина
rule = правило
run = бежать
sad = грустный
salad = салат
salt = соль
same = такой же
sandwich = сэндвич
Saturday = суббота
say = сказать
school = школа
science = наука
scientist = ученый
sea = море
second = второй
section = секция, раздел
see = видеть
sell = продавать
send = отправлять
sentence = предложение (в тексте)
September = сентябрь
seven = семь
seventeen = семнадцать
seventy = семьдесят
share = делиться
she = она
sheep = овца
shirt = рубашка
shoe = обувь
shop = магазин
shopping = покупки
short = короткий
should = следует
show = показывать
shower = душ
sick = больной
similar = похожий
sing = петь
singer = певец
sister = сестра
sit = сидеть
situation = ситуация
six = шесть
sixteen = шестнадцать
sixty = шестьдесят
skill = навык
skirt = юбка
sleep = спать
slow = медленный
small = маленький
snow = снег
so = так
some = некоторые
somebody = кто-то
someone = кто-то
something = что-то
sometimes = иногда
son = сын
song = песня
soon = скоро
sorry = извините
sound = звук
soup = суп
south = юг
space = пространство
speak = говорить
special = особенный
spell = произносить по буквам
spelling = правописание
spend = тратить
sport = спорт
spring = весна
stand = стоять
star = звезда
start = начинать
statement = заявление
station = станция
stay = оставаться
still = всё ещё
stop = остановка, останавливаться
story = история
street = улица
strong = сильный
student = студент
study = учиться
style = стиль
subject = предмет
success = успех
sugar = сахар
summer = лето
sun = солнце
Sunday = воскресенье
supermarket = супермаркет
sure = уверен
sweater = свитер
swim = плавать
swimming = плавание
table = стол
take = брать
talk = говорить
tall = высокий
taxi = такси
tea = чай
teach = учить
teacher = учитель
team = команда
teenager = подросток
telephone = телефон
television = телевидение
tell = рассказывать
ten = десять
tennis = теннис
terrible = ужасный
test = тест
text = текст
than = чем
thank = благодарить
thanks = спасибо
that = то, что
the = этот
theatre = театр
their = их
them = им
then = потом
there = там
they = они
thing = вещь
think = думать
third = третий
thirsty = жаждущий
thirteen = тринадцать
thirty = тридцать
this = этот
three = три
through = через
Thursday = четверг
ticket = билет
time = время
tired = усталый
title = заголовок
to = к, на
today = сегодня
together = вместе
toilet = туалет
tomato = помидор
tomorrow = завтра
tonight = сегодня вечером
too = тоже
tooth = зуб
topic = тема
tourist = турист
town = город
traffic = движение
train = поезд
travel = путешествовать
tree = дерево
trip = поездка
trousers = брюки
true = правда
try = пробовать
T-shirt = футболка
Tuesday = вторник
turn = поворачивать
TV = телевидение
twelve = двенадцать
twenty = двадцать
twice = дважды
two = два
type = тип
umbrella = зонт
uncle = дядя
under = под
understand = понимать
university = университет
up = вверх
upstairs = наверх
us = нас
use = использовать
useful = полезный
usually = обычно
vacation = отпуск
vegetable = овощ
very = очень
visit = посещать
visitor = посетитель
wait = ждать
waiter = официант
wake = просыпаться
walk = гулять
wall = стена
want = хотеть
warm = теплый
wash = мыть
watch = смотреть
water = вода
way = путь
we = мы
wear = носить (одежду)
weather = погода
website = вебсайт
Wednesday = среда
week = неделя
weekend = выходные
welcome = добро пожаловать
well = хорошо
west = запад
what = что
when = когда
white = белый
who = кто
why = почему
wife = жена
will = будет
win = выигрывать
window = окно
wine = вино
winter = зима
with = с
without = без
woman = женщина
wonderful = замечательный
word = слово
work = работа
worker = работник
world = мир
would = бы
write = писать
writer = писатель
writing = письмо
wrong = неправильный
yeah = да
year = год
yellow = желтый
yes = да
you = ты, вы
young = молодой
your = твой, ваш
yourself = сам, себя

