all right = хорошо
anymore = больше не
bear (animal) = медведь
light (a lamp) = свет (лампа)
light (not heavy) = лёгкий (по весу)
may = может
modal = модальный (глагол)
mine (belongs to me) = моё
per cent = процент
race (run) = гонка
second (next) = второй
used to = привык
ability = способность
able = способный
abroad = за границей
accept = принимать
accident = несчастный случай
achieve = достигать
act = действовать
active = активный
actually = на самом деле
adult = взрослый
advantage = преимущество
adventure = приключение
advertise = рекламировать
advertisement = реклама
advertising = рекламный бизнес
affect = влиять
after = после
against = против
ah = ах
airline = авиакомпания
alive = живой
all = все
allow = позволять
almost = почти
alone = один
along = вдоль
already = уже
alternative = альтернатива
although = хотя
among = среди
amount = количество
ancient = древний
ankle = лодыжка
any = любой
anybody = кто-нибудь
anyway = в любом случае
anywhere = где угодно
app = приложение
appear = появляться
appearance = внешность
apply = применять, подавать заявку
architect = архитектор
architecture = архитектура
argue = спорить
argument = спор
army = армия
arrange = организовать
arrangement = договоренность
as = как
asleep = спящий
assistant = помощник
athlete = спортсмен
attack = нападение
attend = посещать
attention = внимание
attractive = привлекательный
audience = аудитория
author = автор
available = доступный
average = средний
avoid = избегать
award = награда
awful = ужасный
back = назад
background = фон
badly = плохо
bar = бар
baseball = бейсбол
based = основанный
basketball = баскетбол
bean = фасоль
beat = бить
beef = говядина
before = до
behave = вести себя
behaviour = поведение
belong = принадлежать
belt = ремень
benefit = выгода
best = лучший
better = лучше
between = между
billion = миллиард
bin = мусорное ведро
biology = биология
birth = рождение
biscuit = печенье
bit = кусочек
blank = пустой
blood = кровь
blow = дуть
board = доска
boil = кипятить
bone = кость
book = книга
borrow = брать взаймы
boss = босс
bottom = дно
bowl = миска
brain = мозг
bridge = мост
bright = яркий
brilliant = блестящий
broken = сломанный
brush = щетка, чистить
burn = гореть
businessman = бизнесмен
button = кнопка
camp = лагерь
camping = кемпинг
can = мочь, банка
care = забота
careful = осторожный
carefully = осторожно
carpet = ковёр
cartoon = мультфильм
case = случай, дело
cash = наличные
castle = замок
catch = ловить
cause = причина
celebrate = праздновать
celebrity = знаменитость
certain = определённый
certainly = конечно
chance = шанс
character = персонаж
charity = благотворительность
chat = болтать
check = проверять
chef = шеф-повар
chemistry = химия
chip = чип
choice = выбор
church = церковь
cigarette = сигарета
circle = круг
classical = классический
clear = ясный
clearly = ясно
clever = умный
climate = климат
close = закрывать
closed = закрытый
clothing = одежда
cloud = облако
coach = тренер
coast = побережье
code = код
colleague = коллега
collect = собирать
column = колонка
comedy = комедия
comfortable = удобный
comment = комментарий
communicate = общаться
community = сообщество
compete = соревноваться
competition = соревнование
complain = жаловаться
completely = полностью
condition = условие
conference = конференция
connect = соединять
connected = подключенный
consider = рассматривать
contain = содержать
context = контекст
continent = континент
continue = продолжать
control = контролировать
cook = готовить
cooker = плита
copy = копировать
corner = угол
correctly = правильно
count = считать
couple = пара
cover = покрывать
crazy = сумасшедший
creative = креативный
credit = кредит
crime = преступление
criminal = преступник
cross = пересекать
crowd = толпа
crowded = переполненный
cry = плакать
cupboard = шкаф
curly = кудрявый
cycle = ездить на велосипеде
daily = ежедневно
danger = опасность
dark = тёмный
data = данные
dead = мёртвый
deal = сделка
dear = дорогой
death = смерть
decision = решение
deep = глубокий
definitely = определённо
degree = степень
dentist = стоматолог
department = отдел
depend = зависеть
desert = пустыня
designer = дизайнер
destroy = уничтожать
detective = детектив
develop = развивать
device = устройство
diary = дневник
differently = по-другому
digital = цифровой
direct = направлять
direction = направление
director = директор
disagree = не соглашаться
disappear = исчезать
disaster = катастрофа
discover = обнаруживать
discovery = открытие
discussion = обсуждение
disease = болезнь
distance = расстояние
divorced = разведённый
document = документ
double = двойной
download = загружать
downstairs = вниз по лестнице
drama = драма
drawing = рисунок
dream = мечтать
drive = водить
driving = вождение
drop = ронять
drug = наркотик
dry = сухой
earn = зарабатывать
earth = земля
easily = легко
education = образование
effect = эффект
either = либо
electric = электрический
electrical = электрический
electricity = электричество
electronic = электронный
employ = нанимать
employee = сотрудник
employer = работодатель
empty = пустой
ending = конец
energy = энергия
engine = двигатель
engineer = инженер
enormous = огромный
enter = входить
environment = окружающая среда
equipment = оборудование
error = ошибка
especially = особенно
essay = эссе
everyday = ежедневный
everywhere = везде
evidence = доказательство
exact = точный
exactly = точно
excellent = отличный
except = кроме
exist = существовать
expect = ожидать
experience = опыт
experiment = эксперимент
expert = эксперт
explanation = объяснение
express = выражать
expression = выражение
extreme = экстремальный
extremely = чрезвычайно
factor = фактор
factory = фабрика
fail = провалиться
fair = честный
fall = падать
fan = поклонник
farm = ферма
farming = фермерство
fashion = мода
fat = жирный
fear = страх
feature = особенность
feed = кормить
female = женский
fiction = фантастика
field = поле
fight = драться
figure = фигура
film = фильм
final = финальный
finally = наконец
finger = палец
finish = заканчивать
first = первый
firstly = во-первых
fish = рыба
fishing = рыбалка
fit = подходить
fix = чинить
flat = квартира, плоский
flu = грипп
fly = летать
flying = полет
focus = фокусироваться
following = следующий
foreign = иностранный
forest = лес
fork = вилка
formal = формальный
fortunately = к счастью
forward = вперёд
free = свободный
fresh = свежий
fridge = холодильник
frog = лягушка
fun = веселье
furniture = мебель
further = дальше
future = будущее
gallery = галерея
gap = разрыв, промежуток
gas = газ
gate = ворота
general = общий
gift = подарок
goal = цель
god = бог
gold = золото
golf = гольф
good = хороший
government = правительство
grass = трава
greet = приветствовать
ground = земля
guest = гость
guide = гид, руководство
gun = оружие
guy = парень
habit = привычка
half = половина
hall = зал
happily = счастливо
have = иметь
headache = головная боль
heart = сердце
heat = тепло
heavy = тяжелый
height = рост, высота
helpful = полезный
hero = герой
hers = её
herself = она сама
hide = прятать
high = высокий
hill = холм
himself = он сам
his = его
hit = ударять
hockey = хоккей
hold = держать
hole = дыра
home = дом
hope = надежда
huge = огромный
human = человек, человеческий
hurt = ранить
ideal = идеальный
identify = идентифицировать
ill = больной
illness = болезнь
image = изображение
immediately = немедленно
impossible = невозможный
included = включённый
including = включая
increase = увеличивать
incredible = невероятный
independent = независимый
individual = индивидуальный
industry = промышленность
informal = неформальный
injury = травма
insect = насекомое
inside = внутри
instead = вместо
instruction = инструкция
instructor = инструктор
instrument = инструмент
intelligent = умный
international = международный
introduction = введение
invent = изобретать
invention = изобретение
invitation = приглашение
invite = приглашать
involve = вовлекать
item = предмет
itself = само
jam = варенье
jazz = джаз
jewellery = украшения
joke = шутка
journalist = журналист
jump = прыгать
kid = ребёнок
kill = убивать
king = король
knee = колено
knife = нож
knock = стучать
knowledge = знания
lab = лаборатория
lady = дама
lake = озеро
lamp = лампа
land = земля
laptop = ноутбук
last = последний
later = позже
laughter = смех
law = закон
lawyer = юрист
lazy = ленивый
lead = вести
leader = лидер
learning = обучение
least = наименьший
lecture = лекция
lemon = лимон
lend = одалживать
less = меньше
level = уровень
lifestyle = образ жизни
lift = поднимать
likely = вероятный
link = ссылка
listener = слушатель
little = маленький
lock = замок
look = смотреть
lorry = грузовик
lost = потерянный
loud = громкий
loudly = громко
lovely = прекрасный
low = низкий
luck = удача
lucky = удачливый
mail = почта
major = главный
male = мужской
manage = управлять
manager = менеджер
manner = манера
mark = отметка
marry = жениться
material = материал
mathematics = математика
maths = математика
matter = дело, вопрос
media = медиа
medical = медицинский
medicine = лекарство
memory = память
mention = упоминать
metal = металл
method = метод
middle = середина
might = может быть
mind = разум
mirror = зеркало
missing = отсутствующий
mobile = мобильный
monkey = обезьяна
moon = луна
mostly = в основном
motorcycle = мотоцикл
movement = движение
musical = музыкальный
musician = музыкант
myself = я сам
narrow = узкий
national = национальный
nature = природа
nearly = почти
necessary = необходимый
neck = шея
need = нуждаться
neither = ни один
nervous = нервный
network = сеть
noise = шум
noisy = шумный
none = никто
normal = нормальный
normally = обычно
notice = замечать
novel = роман
nowhere = нигде
number = номер, число
nut = орех
ocean = океан
offer = предлагать
officer = офицер
oil = масло, нефть
onto = на
opportunity = возможность
option = вариант
ordinary = обычный
organisation = организация
organise = организовать
original = оригинальный
ourselves = мы сами
outside = снаружи
oven = духовка
own = владеть
owner = владелец
pack = упаковывать
pain = боль
painter = художник
palace = дворец
pants = брюки
parking = парковка
particular = конкретный
pass = проходить
passenger = пассажир
past = прошлое
patient = пациент, терпеливый
pattern = шаблон, узор
pay = платить
peace = мир
penny = пенни
per = за (единицу)
perform = выполнять
perhaps = возможно
permission = разрешение
personality = личность
pet = домашнее животное
petrol = бензин
photograph = фотография
physical = физический
physics = физика
pick = выбирать, подбирать
pilot = пилот
planet = планета
plant = растение
plastic = пластик
plate = тарелка
platform = платформа
please = пожалуйста
pleased = довольный
pocket = карман
polite = вежливый
pollution = загрязнение
pop = поп-музыка
population = население
position = позиция
possession = владение
possibility = возможность
poster = плакат
power = сила, энергия
predict = предсказывать
present = настоящее, подарок
president = президент
prevent = предотвращать
print = печатать
printer = принтер
prison = тюрьма
prize = приз
process = процесс
produce = производить
professional = профессиональный
professor = профессор
profile = профиль
program = программа
progress = прогресс
promise = обещание
pronounce = произносить
protect = защищать
provide = предоставлять
pub = паб
public = общественный
publish = публиковать
pull = тянуть
purpose = цель
push = толкать
quality = качество
quantity = количество
queen = королева
question = вопрос
quietly = тихо
railway = железная дорога
raise = поднимать
rate = оценка, ставка
rather = скорее
reach = достигать
react = реагировать
realize = осознавать
receive = получать
recent = недавний
recently = недавно
reception = приём
recipe = рецепт
recognise = узнавать
recommend = рекомендовать
record = запись
recording = запись (процесс)
recycle = перерабатывать
reduce = уменьшать
refer = ссылаться
refuse = отказываться
region = регион
regular = регулярный
relationship = отношения
remove = удалять
repair = ремонтировать
replace = заменять
reply = отвечать
report = отчёт
reporter = репортёр
request = запрос
research = исследование
researcher = исследователь
respond = отвечать
response = ответ
rest = отдых
review = обзор
ride = ехать
ring = кольцо, звонить
rise = подниматься
rock = скала, рок-музыка
role = роль
roof = крыша
round = круглый
route = маршрут
rubbish = мусор
rude = грубый
run = бегать
runner = бегун
running = бег
sadly = печально
safe = безопасный
sail = парус
sailing = плавание под парусом
salary = зарплата
sale = распродажа
sauce = соус
save = сохранять
scared = испуганный
scary = страшный
scene = сцена
schedule = расписание
score = счёт (в игре)
screen = экран
search = поиск
season = сезон
seat = сиденье
secondly = во-вторых
secret = секрет
secretary = секретарь
seem = казаться
sense = смысл, чувство
separate = разделять
series = серия
serious = серьёзный
serve = обслуживать
service = сервис
several = несколько
shake = трясти
shall = должен
shape = форма
sheet = лист
ship = корабль
shoulder = плечо
shout = кричать
shut = закрывать
side = сторона
sign = знак
silver = серебро
simple = простой
since = с тех пор
singing = пение
single = одинокий
sir = сэр
site = сайт, место
size = размер
ski = лыжи
skiing = катание на лыжах
skin = кожа
sky = небо
sleep = спать
slowly = медленно
smartphone = смартфон
smell = запах
smile = улыбка
smoke = дым, курить
smoking = курение
soap = мыло
soccer = футбол
social = социальный
society = общество
sock = носок
soft = мягкий
soldier = солдат
solution = решение
solve = решать
somewhere = где-то
sort = сорт
source = источник
speaker = динамик, оратор
specific = конкретный
speech = речь
speed = скорость
spider = паук
spoon = ложка
square = площадь
stage = сцена
stair = ступенька
stamp = марка
star = звезда
start = начинать
state = состояние, государство
stay = оставаться
steal = красть
step = шаг
stomach = желудок
stone = камень
store = магазин
storm = буря
straight = прямо
strange = странный
strategy = стратегия
stress = стресс
structure = структура
stupid = глупый
succeed = преуспеть
successful = успешный
such = такой
suddenly = внезапно
suggest = предлагать
suggestion = предложение
suit = костюм
support = поддерживать
suppose = предполагать
sure = уверен
surprise = сюрприз
surprised = удивлённый
surprising = удивительный
survey = опрос
sweet = сладкий
symbol = символ
system = система
tablet = планшет
talk = говорить
target = цель
task = задание
taste = вкус
teaching = обучение
technology = технология
teenage = подростковый
temperature = температура
term = срок, термин
text = текст
themselves = они сами
thick = толстый
thief = вор
thin = тонкий
thinking = размышление
third = третий
thought = мысль
throw = бросать
tidy = аккуратный, прибирать
tie = галстук
tip = совет, чаевые
tool = инструмент
top = вершина
touch = трогать
tour = тур
tourism = туризм
towards = к (направление)
towel = полотенце
tower = башня
toy = игрушка
track = трек
tradition = традиция
traditional = традиционный
train = поезд
trainer = тренер
training = тренировка
transport = транспорт
traveller = путешественник
trouble = проблема
truck = грузовик
twin = близнец
typical = типичный
underground = метро
understanding = понимание
unfortunately = к сожалению
unhappy = несчастный
uniform = форма (одежда)
unit = единица
united = объединённый
unusual = необычный
upstairs = наверху
use = использовать
user = пользователь
usual = обычный
valley = долина
van = фургон
variety = разнообразие
vehicle = транспортное средство
view = вид
virus = вирус
voice = голос
wait = ждать
war = война
wash = мыть
washing = стирка
wave = волна, махать
weak = слабый
web = паутина, сеть
wedding = свадьба
weight = вес
welcome = добро пожаловать
wet = мокрый
wheel = колесо
while = в то время как
whole = целый
whose = чей
wide = широкий
wild = дикий
wind = ветер
winner = победитель
wish = желать
wood = дерево
wooden = деревянный
working = работающий
worried = обеспокоенный
worry = волноваться
worse = хуже
worst = наихудший
wow = вау
yet = ещё
yours = ваш, твой
zero = ноль
