absolutely = абсолютно
academic = академический
access = доступ
accommodation = жильё
account = аккаунт
achievement = достижение
act = действие
ad = реклама
addition = добавление
admire = восхищаться
admit = признать
advanced = продвинутый
advise = советовать
afford = позволить себе
age = возраст
aged = в возрасте
agent = агент
agreement = соглашение
ahead = впереди
aim = цель
alarm = тревога
album = альбом
alcohol = алкоголь
alcoholic = алкоголик
alternative = альтернатива
amazed = поражённый
ambition = амбиция
ambitious = амбициозный
analyse = анализировать
analysis = анализ
announce = объявить
announcement = объявление
annoy = раздражать
annoyed = раздражённый
annoying = раздражающий
apart = отдельно
apologize = извиняться
application = приложение, заявление
appointment = встреча
appreciate = ценить
approximately = приблизительно
arrest = арестовать
arrival = прибытие
assignment = задание
assist = помогать
atmosphere = атмосфера
attach = прикрепить
attitude = отношение
attract = привлекать
attraction = достопримечательность
authority = власть
average = средний
award = награда
aware = осведомлённый
backwards = назад
bake = печь
balance = баланс
ban = запретить
base = основа
basic = базовый
basis = основа
battery = батарея
battle = битва
beauty = красота
bee = пчела
belief = вера
bell = колокол
bend = сгибать
benefit = выгода
better = лучше
bite = укус
block = блок
board = доска
bomb = бомба
border = граница
bother = беспокоить
branch = ветвь
brand = бренд
brave = храбрый
breath = дыхание
breathe = дышать
breathing = дыхание
bride = невеста
bubble = пузырь
bury = хоронить
by = около
calm = спокойствие
campaign = кампания
campus = кампус
candidate = кандидат
cap = кепка
captain = капитан
careless = небрежный
category = категория
ceiling = потолок
celebration = празднование
central = центральный
centre = центр
ceremony = церемония
chain = цепь
challenge = вызов
champion = чемпион
channel = канал
chapter = глава
charge = заряд
cheap = дешёвый
cheat = обманывать
cheerful = весёлый
chemical = химический
chest = грудь
childhood = детство
claim = требовать
clause = пункт
clear = ясный
click = щелчок
client = клиент
climb = взбираться
close = закрывать
cloth = ткань
clue = ключ к разгадке
coach = тренер
coal = уголь
coin = монета
collection = коллекция
coloured = цветной
combine = объединять
comment = комментарий
commercial = коммерческий
commit = совершать
communication = коммуникация
comparison = сравнение
competitor = конкурент
competitive = конкурентоспособный
complaint = жалоба
complex = сложный
concentrate = концентрироваться
conclude = заключать
conclusion = заключение
confident = уверенный
confirm = подтверждать
confuse = путать
confused = сбитый с толку
connection = связь
consequence = последствие
consist = состоять
consume = потреблять
consumer = потребитель
contact = контакт
container = контейнер
content = содержимое
continuous = непрерывный
contrast = контраст
convenient = удобный
convince = убеждать
cool = классный
costume = костюм
cottage = коттедж
cotton = хлопок
count = считать
countryside = сельская местность
court = суд
cover = покрытие
covered = покрытый
cream = крем
criminal = преступник
cruel = жестокий
cultural = культурный
currency = валюта
current = текущий
currently = в настоящее время
curtain = занавеска
custom = обычай
cut = резать
daily = ежедневный
damage = повреждение
deal = сделка
decade = десятилетие
decorate = украшать
deep = глубокий
define = определять
definite = определённый
definition = определение
deliver = доставлять
departure = отъезд
despite = несмотря на
destination = пункт назначения
determine = определять
determined = решительный
development = развитие
diagram = диаграмма
diamond = алмаз
difficulty = трудность
direct = прямой
directly = прямо
dirt = грязь
disadvantage = недостаток
disappointed = разочарованный
disappointing = разочаровывающий
discount = скидка
dislike = не нравиться
divide = делить
documentary = документальный фильм
donate = жертвовать
double = двойной
doubt = сомнение
dressed = одетый
drop = ронять
drum = барабан
drunk = пьяный
due = должный
dust = пыль
duty = долг
earthquake = землетрясение
eastern = восточный
economic = экономический
economy = экономика
edge = край
editor = редактор
educate = обучать
educated = образованный
educational = образовательный
effective = эффективный
effectively = эффективно
effort = усилие
election = выборы
element = элемент
embarrassed = смущённый
embarrassing = смущающий
emergency = чрезвычайная ситуация
emotion = эмоция
employment = трудоустройство
empty = пустой
encourage = поощрять
enemy = враг
engaged = помолвленный
engineering = инженерное дело
entertain = развлекать
entertainment = развлечение
entrance = вход
entry = запись
environmental = экологический
episode = эпизод
equal = равный
equally = в равной степени
escape = сбегать
essential = существенный
eventually = в конце концов
examine = осматривать
except = кроме
exchange = обменивать
excitement = волнение
exhibition = выставка
expand = расширять
expected = ожидаемый
expedition = экспедиция
experience = опыт
experienced = опытный
experiment = эксперимент
explode = взрываться
explore = исследовать
explosion = взрыв
export = экспорт
extra = дополнительный
face = лицо
fairly = довольно
familiar = знакомый
fancy = причудливый
far = далеко
fascinating = захватывающий
fashionable = модный
fasten = закреплять
favour = услуга
fear = страх
feature = особенность
fence = забор
fighting = борьба
file = файл
financial = финансовый
fire = огонь
fitness = фитнес
fixed = фиксированный
flag = флаг
flood = наводнение
flour = мука
flow = поток
fold = складывать
folk = народ
following = следующий
force = сила
forever = навсегда
frame = рамка
freeze = замерзать
frequently = часто
friendship = дружба
frighten = пугать
frightened = напуганный
frightening = пугающий
frozen = замороженный
fry = жарить
fuel = топливо
function = функция
fur = мех
further = далее
garage = гараж
gather = собирать
generally = в общем
generation = поколение
generous = щедрый
gentle = мягкий
gentleman = джентльмен
ghost = призрак
giant = гигант
glad = рад
global = глобальный
glove = перчатка
go = идти
goods = товары
grade = оценка
graduate = выпускник
grain = зерно
grateful = благодарный
growth = рост
guard = охранник
guilty = виновный
hand = рука
hang = вешать
happiness = счастье
hardly = едва
hate = ненавидеть
head = голова
headline = заголовок
heating = отопление
heavily = сильно
helicopter = вертолёт
highlight = выделять
highly = очень
hire = нанимать
historic = исторический
historical = исторический
honest = честный
horrible = ужасный
horror = ужас
host = хозяин
hunt = охотиться
hurricane = ураган
hurry = спешить
identity = идентичность
ignore = игнорировать
illegal = незаконный
imaginary = воображаемый
immediate = немедленный
immigrant = иммигрант
impact = воздействие
import = импорт
importance = важность
impression = впечатление
impressive = впечатляющий
improvement = улучшение
incredibly = невероятно
indeed = действительно
indicate = указывать
indirect = косвенный
indoor = в помещении
indoors = в помещении
influence = влияние
ingredient = ингредиент
injure = ранить
injured = раненый
innocent = невиновный
intelligence = интеллект
intend = намереваться
intention = намерение
invest = инвестировать
investigate = расследовать
involved = вовлечённый
iron = железо
issue = проблема
IT = информационные технологии
journal = журнал
judge = судья
keen = увлечённый
key = ключ
keyboard = клавиатура
kick = пинать
killing = убийство
kiss = поцелуй
knock = стучать
label = этикетка
laboratory = лаборатория
lack = нехватка
latest = последний
lay = класть
layer = слой
lead = вести
leading = ведущий
leaf = лист
leather = кожа (материал)
legal = законный
leisure = досуг
length = длина
limit = ограничение
lip = губа
liquid = жидкость
literature = литература
live = жить
living = жизнь
local = местный
locate = находиться
located = расположенный
location = местоположение
lonely = одинокий
loss = потеря
luxury = роскошь
mad = сумасшедший
magic = магия
mainly = главным образом
mall = торговый центр
management = управление
market = рынок
marketing = маркетинг
marriage = брак
meanwhile = тем временем
measure = измерять
medium = средний
mental = умственный
mention = упоминать
mess = беспорядок
mild = мягкий
mix = смешивать
mixture = смесь
mood = настроение
move = двигаться
mud = грязь
murder = убийство
muscle = мышца
musical = музыкальный
mystery = тайна
nail = ноготь
narrative = повествование
nation = нация
native = родной
naturally = естественно
necessarily = обязательно
need = нуждаться
needle = игла
neighbourhood = соседство
neither = ни
net = сеть
next = следующий
nor = ни
normal = нормальный
northern = северный
note = заметка
nuclear = ядерный
obvious = очевидный
obviously = очевидно
occasion = случай
occur = происходить
odd = странный
official = официальный
old-fashioned = старомодный
once = однажды
operation = операция
organised = организованный
organiser = организатор
original = оригинальный
originally = первоначально
ought = должен
ours = наш
outdoor = на улице
outdoors = на улице
pack = упаковывать
package = упаковка
painful = болезненный
pale = бледный
pan = кастрюля
participate = участвовать
particularly = особенно
pass = проходить
passion = страсть
path = путь
payment = оплата
peaceful = мирный
percentage = процент
perfectly = совершенно
performance = выступление
personally = лично
persuade = убеждать
photographer = фотограф
photography = фотография
pin = булавка
pipe = труба
place = место
planning = планирование
pleasant = приятный
pleasure = удовольствие
plenty = много
plot = сюжет
plus = плюс
poem = стихотворение
poet = поэт
poetry = поэзия
point = точка
poison = яд
poisonous = ядовитый
policy = политика
political = политический
politician = политик
politics = политика
port = порт
portrait = портрет
possibly = возможно
pot = горшок
pour = наливать
poverty = бедность
powder = порошок
powerful = мощный
practical = практичный
pray = молиться
prayer = молитва
prediction = предсказание
prepared = подготовленный
presentation = презентация
press = пресса
pressure = давление
pretend = притворяться
previous = предыдущий
previously = ранее
priest = священник
primary = основной
prince = принц
princess = принцесса
printing = печать
prisoner = заключённый
private = частный
producer = продюсер
production = производство
profession = профессия
profit = прибыль
programme = программа
promote = продвигать
proper = правильный
properly = правильно
property = собственность
protest = протест
proud = гордый
prove = доказывать
pull = тянуть
punish = наказывать
punishment = наказание
push = толкать
qualification = квалификация
qualified = квалифицированный
qualify = соответствовать
queue = очередь
quit = бросать
quotation = цитата
quote = цитировать
racing = гонка
range = диапазон
rare = редкий
rarely = редко
reaction = реакция
reality = реальность
receipt = квитанция
recommendation = рекомендация
reference = ссылка
reflect = отражать
regularly = регулярно
reject = отвергать
relate = относиться
related = связанный
relation = отношение
relative = родственник
relaxed = расслабленный
relaxing = расслабляющий
release = выпускать
reliable = надёжный
religion = религия
religious = религиозный
remain = оставаться
remind = напоминать
remote = удалённый
rent = арендовать
repair = чинить
repeat = повторять
repeated = повторный
represent = представлять
request = запрос
require = требовать
reservation = бронирование
resource = ресурс
respect = уважение
responsibility = ответственность
responsible = ответственный
result = результат
retire = уходить на пенсию
retired = на пенсии
revise = пересматривать
ring = кольцо
rise = подниматься
risk = риск
robot = робот
roll = катиться
romantic = романтический
rope = верёвка
rough = грубый
row = ряд
royal = королевский
rugby = регби
rule = правило
safety = безопасность
sail = парус
sailor = моряк
sample = образец
sand = песок
scan = сканировать
scientific = научный
script = сценарий
sculpture = скульптура
secondary = вторичный
security = безопасность
seed = семя
sensible = разумный
separate = отдельный
seriously = серьёзно
servant = слуга
setting = установка
sex = пол
sexual = сексуальный
shake = трясти
share = делиться
sharp = острый
shelf = полка
shell = раковина
shift = смена
shine = сиять
shiny = блестящий
shoot = стрелять
shy = стеснительный
sight = зрение
signal = сигнал
silent = молчаливый
silly = глупый
similarity = сходство
similarly = аналогично
simply = просто
since = с (времени)
sink = раковина
slice = ломтик
slightly = слегка
slow = медленный
smart = умный
smooth = гладкий
software = программное обеспечение
soil = почва
solid = твёрдый
sort = сорт
southern = южный
specifically = конкретно
spending = траты
spicy = острый (на вкус)
spirit = дух
spoken = устный
spot = пятно
spread = распространять
spring = весна
stadium = стадион
staff = персонал
standard = стандарт
state = состояние, государство
statistic = статистика
statue = статуя
still = все еще
store = магазин
stranger = незнакомец
strength = сила
string = струна
strongly = сильно
studio = студия
stuff = вещи
substance = вещество
successfully = успешно
sudden = внезапный
suffer = страдать
suit = костюм
suitable = подходящий
summarise = подводить итоги
summary = краткое содержание
supply = поставка
supporter = сторонник
surely = наверняка
surface = поверхность
survive = выживать
swim = плавать
switch = переключатель
symptom = симптом
tail = хвост
talent = талант
talented = талантливый
tape = лента
tax = налог
technical = технический
technique = техника
tend = склоняться
tent = палатка
that = тот
theirs = их
theme = тема
theory = теория
therefore = следовательно
this = этот
though = хотя
throat = горло
throughout = по всему
tight = тугой
till = до
tin = жестяная банка
tiny = крошечный
tip = совет
toe = палец ноги
tongue = язык
total = общий
totally = полностью
touch = касаться
tour = тур
trade = торговля
translate = переводить
translation = перевод
transport = транспорт
treat = лечить
treatment = лечение
trend = тренд
trick = трюк
truth = правда
tube = трубка
type = тип
typically = типично
tyre = шина
ugly = уродливый
unable = неспособный
uncomfortable = неудобный
underwear = нижнее бельё
unemployed = безработный
unemployment = безработица
unfair = несправедливый
union = союз
unless = если не
unlike = непохожий
unlikely = маловероятный
unnecessary = ненужный
unpleasant = неприятный
update = обновление
upon = на
upset = расстроенный
used = использованный
valuable = ценный
value = ценность
various = разнообразный
version = версия
victim = жертва
view = вид
viewer = зритель
violent = жестокий
volunteer = доброволец
vote = голос
warm = тёплый
warn = предупреждать
warning = предупреждение
waste = отходы
water = вода
wave = волна
weapon = оружие
weigh = взвешивать
western = западный
whatever = что угодно
whenever = когда угодно
whether = ли
while = в то время как
whole = целый
will = воля, желание
win = выигрывать
wing = крыло
within = внутри
wonder = удивляться
wool = шерсть
worldwide = всемирный
worry = беспокоиться
worse = хуже
worst = худший
worth = стоящий
written = написанный
wrong = неправильный
yard = двор
young = молодой
youth = молодёжь
bank (river) = берег (реки)
kind (caring) = добрый
level = уровень
lie (tell a lie) = лгать
mine (hole) = шахта
race (people) = раса
set (put) = установить
set (group) = набор
stick (attach) = прикрепить
stick (piece of wood) = палка
