alongside = рядом, бок о бок
bear (deal with) = терпеть
beside = рядом с
besides = кроме того
but = но
counter (flat surface) = прилавок, стойка
abandon = покидать
absolute = абсолютный
absorb = поглощать
abstract = абстрактный
academic = академический
accent = акцент
acceptable = приемлемый
accidentally = случайно
accommodate = размещать
accommodation = жильё
accompany = сопровождать
accomplish = выполнять
account = учётная запись
accountant = бухгалтер
accuracy = точность
accurate = точный
accurately = точно
accuse = обвинять
acknowledge = признавать
acquire = приобретать
acre = акр
activate = активировать
actual = фактический
adapt = адаптировать
addiction = зависимость
additional = дополнительный
additionally = дополнительно
address = адрес
adequate = адекватный
adequately = адекватно
adjust = регулировать
administration = администрация
adopt = усыновлять, принимать
advance = продвижение
affair = дело
affordable = доступный
afterwards = впоследствии
aged = в возрасте
agency = агентство
agenda = повестка дня
aggressive = агрессивный
agriculture = сельское хозяйство
aid = помощь
AIDS = СПИД
aircraft = самолёт
alarm = тревога
alien = пришелец
alter = изменять
altogether = в целом
ambitious = амбициозный
ambulance = скорая помощь
amount = количество
amusing = забавный
analyst = аналитик
ancestor = предок
anger = гнев
angle = угол
animation = анимация
anniversary = годовщина
annual = ежегодный
annually = ежегодно
anticipate = предвидеть
anxiety = тревога
anxious = тревожный
apology = извинение
apparent = очевидный
apparently = по-видимому
appeal = обращение
applicant = заявитель
approach = подход
appropriate = соответствующий
appropriately = соответствующе
approval = одобрение
approve = одобрять
arise = возникать
armed = вооружённый
arms = оружие
arrow = стрела
artificial = искусственный
artistic = художественный
artwork = произведение искусства
ashamed = стыдящийся
aspect = аспект
assess = оценивать
assessment = оценка
asset = актив
assign = назначать
assistance = помощь
associate = ассоциировать
associated = связанный
association = ассоциация
assume = предполагать
assumption = предположение
assure = уверять
astonishing = поразительный
athletic = спортивный
attachment = вложение
attempt = попытка
audio = аудио
awareness = осведомлённость
awkward = неловкий
back = назад
bacteria = бактерии
badge = значок
balanced = сбалансированный
ballet = балет
balloon = воздушный шар
bar = бар
barely = едва
bargain = выгодная сделка
barrier = барьер
basement = подвал
basically = в основном
basket = корзина
bat = бита
battle = битва
beat = бить
beg = умолять
being = существо
beneficial = полезный
bent = изогнутый
bet = ставка
beyond = за пределами
bias = предвзятость
bid = ставка
bill = счёт
biological = биологический
bitter = горький
blame = обвинять
blanket = одеяло
blind = слепой
blow = дуть
bold = смелый
bombing = бомбардировка
bond = связь
boost = увеличение
border = граница
bound = обязанный
breast = грудь
brick = кирпич
brief = краткий
briefly = кратко
broad = широкий
broadcast = транслировать
broadcaster = диктор
broadly = широко
buck = доллар
budget = бюджет
bug = жук, ошибка
bullet = пуля
bunch = пучок
burn = гореть
bush = куст
cabin = хижина
cable = кабель
calculate = вычислять
canal = канал
cancel = отменять
cancer = рак
candle = свеча
capable = способный
capacity = вместимость
capture = захватывать
carbon = углерод
cast = бросать
castle = замок
casual = повседневный
catch = ловить
cave = пещера
cell = клетка
certainty = уверенность
certificate = сертификат
chain = цепь
chair = стул
chairman = председатель
challenge = вызов
challenging = трудный
championship = чемпионат
characteristic = характеристика
charming = очаровательный
chart = диаграмма
chase = преследовать
cheek = щека
cheer = радость
chief = главный
chop = рубить
circuit = цепь
circumstance = обстоятельство
cite = цитировать
citizen = гражданин
civil = гражданский
civilization = цивилизация
clarify = прояснять
classic = классический
classify = классифицировать
cliff = утёс
clinic = клиника
clip = зажим
close = закрывать
closely = тесно
coincidence = совпадение
collapse = коллапс
collector = коллекционер
colony = колония
colorful = красочный
combination = комбинация
comfort = комфорт
comic = комик
command = команда
commander = командир
commission = комиссия
commitment = обязательство
committee = комитет
commonly = обычно
comparative = сравнительный
completion = завершение
complex = сложный
complicated = сложный
component = компонент
compose = составлять
composer = композитор
compound = соединение
comprehensive = комплексный
comprise = включать
compulsory = обязательный
concentration = концентрация
concept = концепция
concern = беспокойство
concerned = обеспокоенный
concrete = бетон
conduct = проводить
confess = признаваться
confidence = уверенность
conflict = конфликт
confusing = запутанный
confusion = путаница
conscious = сознательный
consequently = следовательно
conservation = охрана природы
conservative = консервативный
considerable = значительный
considerably = значительно
consideration = рассмотрение
consistent = последовательный
consistently = последовательно
conspiracy = заговор
constant = постоянный
constantly = постоянно
construct = строить
construction = строительство
consult = консультироваться
consultant = консультант
consumption = потребление
contemporary = современный
contest = конкурс

contract = контракт
contribute = вносить вклад
contribution = вклад
controversial = спорный
controversy = полемика, спор
convenience = удобство
convention = соглашение, конвенция
conventional = традиционный
convert = преобразовывать
convey = передавать
convinced = убеждённый
convincing = убедительный
cop = полицейский
cope = справляться
core = ядро, основа
corporate = корпоративный
corporation = корпорация
corridor = коридор
council = совет
county = графство
courage = мужество
coverage = охват
cowboy = ковбой
crack = трещина
crash = авария
creation = создание
creativity = креативность
creature = существо
credit = кредит
crew = экипаж
crisis = кризис
criterion = критерий
critic = критик
critical = критический
critically = критически
criticism = критика
criticize = критиковать
crop = урожай
crucial = ключевой
cruise = круиз
cry = плакать
cue = сигнал
cure = лечение
curious = любопытный
current = текущий
curriculum = учебный план
curve = кривая
curved = изогнутый
cute = милый

dairy = молочный
dare = осмеливаться
darkness = тьма
database = база данных
date = дата
deadline = крайний срок
deadly = смертельный
dealer = торговец
debate = дебаты
debt = долг
decent = приличный
deck = палуба
declare = объявлять
decline = отклонять
decoration = украшение
decrease = уменьшать
deeply = глубоко
defeat = поражение
defence = оборона
defend = защищать
defender = защитник
delay = задержка
delete = удалять
deliberate = преднамеренный
deliberately = намеренно
delight = восторг
delighted = восхищённый
delivery = доставка
demand = спрос, требовать
democracy = демократия
democratic = демократический
demonstrate = демонстрировать
demonstration = демонстрация
deny = отрицать
depart = уезжать
dependent = зависимый
deposit = депозит
depressed = подавленный
depressing = удручающий
depression = депрессия
depth = глубина
derive = получать, выводить
desert = пустыня
deserve = заслуживать
desire = желание
desperate = отчаянный
desperately = отчаянно
destruction = разрушение
detail = деталь
detailed = подробный
detect = обнаруживать
determination = решимость
devote = посвящать
differ = отличаться
dig = копать
dime = монета
disability = инвалидность
disabled = инвалид
disagreement = разногласие
disappoint = разочаровывать
disappointment = разочарование
disc = диск
discipline = дисциплина
discount = скидка
discourage = обескураживать
dishonest = нечестный
dismiss = отклонять
disorder = беспорядок
display = показывать
distant = далёкий
distinct = отчётливый
distinguish = различать
distract = отвлекать
distribute = распространять
distribution = распределение
district = район
disturb = беспокоить
dive = нырять
diverse = разнообразный
diversity = разнообразие
divide = разделять
division = деление
divorce = развод
document = документ
domestic = домашний
dominant = доминирующий
dominate = доминировать
donation = пожертвование
dot = точка
downwards = вниз
dozen = дюжина
draft = черновик
drag = тащить
dramatic = драматичный
dramatically = значительно
drought = засуха
dull = скучный
dump = свалка
duration = продолжительность
dynamic = динамический
eager = нетерпеливый
economics = экономика
economist = экономист
edit = редактировать
edition = издание
editorial = редакционный
efficient = эффективный
efficiently = эффективно
elbow = локоть
elderly = пожилой
elect = избирать
electronics = электроника
elegant = элегантный
elementary = элементарный
eliminate = устранять
elsewhere = в другом месте
embrace = обнимать
emerge = появляться
emission = выброс
emotional = эмоциональный
emotionally = эмоционально
emphasis = акцент
emphasize = подчёркивать
empire = империя
enable = позволять
encounter = сталкиваться
engage = привлекать
enhance = улучшать
enjoyable = приятный
enquiry = запрос
ensure = обеспечивать
entertaining = развлекательный
enthusiasm = энтузиазм
enthusiastic = восторженный
entire = весь
entirely = полностью
entrepreneur = предприниматель
envelope = конверт
equal = равный
equip = снаряжать
equivalent = эквивалент
era = эра
erupt = извергаться
essentially = по существу
establish = учреждать
estate = недвижимость
estimate = оценивать
ethic = этика
ethical = этический
ethnic = этнический
evaluate = оценивать
evaluation = оценка
even = даже
evident = очевидный
evil = зло
evolution = эволюция
evolve = развиваться
examination = экзамен
exceed = превышать
exception = исключение
excessive = чрезмерный
exclude = исключать
excuse = оправдание
executive = исполнительный
existence = существование
exotic = экзотический
expansion = расширение
expectation = ожидание
expedition = экспедиция
expense = расход
expertise = опыт
exploit = эксплуатировать
exploration = исследование
expose = подвергать
exposure = воздействие
extend = расширять
extension = расширение
extensive = обширный
extensively = широко
extent = степень
external = внешний
extract = извлекать
extraordinary = необычный
extreme = экстремальный
fabric = ткань
fabulous = потрясающий
facility = объект
faculty = факультет
failed = неудачный
failure = неудача
faith = вера
fake = поддельный
fame = слава
fantasy = фантазия
fare = плата за проезд
fault = вина
favour = услуга
feather = перо
fee = плата
feed = кормить
feedback = обратная связь
feel = чувствовать
fellow = приятель
figure = фигура
file = файл
finance = финансы
finding = вывод
firefighter = пожарный
firework = фейерверк
firm = твёрдый
firm = фирма
firmly = твёрдо
fix = чинить
flame = пламя
flash = вспышка
flavor = вкус
flexible = гибкий
float = плавать
fold = складывать
folding = складной
following = следующий
fond = любящий
fool = дурак
forbid = запрещать
forecast = прогноз
forgive = прощать
format = формат
formation = образование
former = бывший
formerly = ранее
fortunate = удачливый
fortune = удача
forum = форум
forward = вперёд
fossil = ископаемое
found = основать
foundation = основание
founder = основатель
fraction = доля
fragment = фрагмент
framework = структура
fraud = мошенничество
free = свободный
freedom = свобода
freely = свободно
frequency = частота
frequent = частый
fuel = топливо
fulfill = выполнять
full-time/adv = полный рабочий день
fully = полностью
function = функция
fund = фонд
fundamental = фундаментальный
fundamentally = в основе
funding = финансирование
furious = яростный
furthermore = кроме того
gain = получать
gallon = галлон
gaming = игры
gang = банда
gay = гей
gender = пол
gene = ген
generate = генерировать
genetic = генетический
genius = гений
genre = жанр
genuine = подлинный
genuinely = искренне
gesture = жест
globalization = глобализация
globe = земной шар
golden = золотой
goodness = доброта
gorgeous = великолепный
govern = управлять
grab = хватать
grade = оценка
gradually = постепенно
grand = великий
grant = предоставлять
graphic = графический
graphics = графика
greatly = значительно
greenhouse = теплица
guarantee = гарантия
guideline = руководство

habitat = среда обитания
handle = справляться
harbor = гавань
harm = вред
harmful = вредный
headquarters = штаб-квартира
heal = исцелять
healthcare = здравоохранение
hearing = слух
heaven = рай
heel = пятка
hell = ад
helmet = шлем
hence = следовательно
herb = трава
hesitate = колебаться
hidden = скрытый
high = высокий
hilarious = уморительный
hip = бедро
hire = нанимать
historian = историк
hold = держать
hollow = полый
holy = святой
homeless = бездомный
honesty = честность
honey = мёд
honour = честь
hook = крюк
hopefully = надеюсь
host = хозяин
house = дом
household = домашнее хозяйство
housing = жильё
humorous = юмористический
humour = юмор
hunger = голод
hunt = охота
hunting = охота
hurt = причинять боль
hypothesis = гипотеза
icon = икона
ID = удостоверение личности
ideal = идеальный
identical = идентичный
illusion = иллюзия
illustrate = иллюстрировать
illustration = иллюстрация
imagination = воображение
immigration = иммиграция
immune = иммунный
impatient = нетерпеливый
implement = осуществлять
implication = последствие
imply = подразумевать
impose = навязывать
impress = впечатлять
impressed = впечатлённый
incentive = стимул
inch = дюйм
incident = случай
income = доход
incorporate = включать
incorrect = неверный
increasingly = всё больше
independence = независимость
index = индекс
indication = указание
industrial = промышленный
inevitable = неизбежный
inevitably = неизбежно
infection = инфекция
infer = делать вывод
inflation = инфляция
info = информация
inform = информировать
infrastructure = инфраструктура
inhabitant = житель
inherit = наследовать
initial = начальный
initially = изначально
initiative = инициатива
ink = чернила
inner = внутренний
innovation = инновация
innovative = инновационный
input = ввод
insert = вставлять
insight = понимание
insist = настаивать
inspector = инспектор
inspire = вдохновлять
install = устанавливать
installation = установка
instance = пример
instant = мгновенный
instantly = мгновенно
institute = институт
institution = учреждение
insurance = страхование
integrate = интегрировать
intellectual = интеллектуальный
intended = предназначенный
intense = интенсивный
interact = взаимодействовать
interaction = взаимодействие
internal = внутренний
interpret = интерпретировать
interpretation = интерпретация
interrupt = прерывать
interval = интервал
invade = вторгаться
invasion = вторжение
investigation = расследование
investment = инвестиция
investor = инвестор
isolate = изолировать
isolated = изолированный
issue = вопрос, проблема
jail = тюрьма
jet = реактивный самолёт
joint = совместный
journalism = журналистика
joy = радость
judgement = суждение
junior = младший
jury = жюри
justice = справедливость
justify = оправдывать
kindergarten = детский сад
kit = набор
labour = труд
ladder = лестница
landing = посадка
landscape = пейзаж
lane = полоса
largely = в значительной степени
lately = недавно
latest = последний
launch = запускать
leadership = лидерство
league = лига
lean = наклоняться
leave = покидать
legend = легенда
lens = линза
level = уровень
licence = лицензия
lifetime = вся жизнь
lighting = освещение
likewise = аналогично
limitation = ограничение
limited = ограниченный
line = линия
literally = буквально
literary = литературный
litter = мусор
lively = оживлённый
load = загружать
loan = заём
logical = логичный
logo = логотип
long-term = долгосрочный
loose = свободный
lord = лорд
lottery = лотерея
low = низкий
lower = снижать
loyal = верный
lung = лёгкое
lyric = текст песни
magnificent = великолепный
maintain = поддерживать
majority = большинство
make = делать
makeup = макияж
making = создание
manufacture = производство
manufacturing = производство
map = карта
marathon = марафон
margin = край
marker = маркер
martial = боевой
mass = масса
massive = массивный
master = мастер
matching = подходящий
mate = товарищ
material = материал
maximum = максимальный
means = средства
measurement = измерение
mechanic = механик
mechanical = механический
mechanism = механизм
medal = медаль
medication = лекарство
medium = средний
melt = таять
membership = членство
memorable = незабываемый
metaphor = метафора
military = военный
miner = шахтёр
mineral = минерал
minimum = минимум
minister = министр
minor = незначительный
minority = меньшинство
miserable = несчастный
mission = миссия
mistake = ошибка
mixed = смешанный
mode = режим
model = модель
modest = скромный
modify = изменять
monitor = монитор
monster = монстр
monthly = ежемесячный
monument = памятник
moral = моральный
moreover = кроме того
mortgage = ипотека
mosque = мечеть
mosquito = комар
motion = движение
motivate = мотивировать
motivation = мотивация
motor = мотор
mount = монтировать
moving = трогательный, движущийся
multiple = множественный
multiply = умножать
mysterious = загадочный
myth = миф
naked = голый
narrow = узкий
nasty = противный
national = национальный
navigation = навигация
nearby = поблизости
neat = аккуратный
necessity = необходимость
negative = отрицательный
negotiate = вести переговоры
negotiation = переговоры
nerve = нерв
neutral = нейтральный
nevertheless = тем не менее
newly = недавно
nickel = никель
nightmare = кошмар
norm = норма
notebook = тетрадь, ноутбук
notion = понятие
novelist = романист
nowadays = в наше время
numerous = многочисленный
nursing = уход
nutrition = питание
obesity = ожирение
obey = подчиняться
object = объект, возражать
objective = цель
obligation = обязательство
observation = наблюдение
observe = наблюдать
observer = наблюдатель
obstacle = препятствие
obtain = получать
occasionally = время от времени
occupation = профессия
occupy = занимать
offence = правонарушение
offend = оскорблять
offender = преступник
offensive = оскорбительный
official = официальный
ongoing = продолжающийся
opening = открытие
openly = открыто
opera = опера
operate = управлять
operator = оператор
opponent = противник
oppose = противостоять
opposed = против
opposition = оппозиция
optimistic = оптимистичный
orchestra = оркестр
organ = орган
organic = органический
origin = происхождение
otherwise = в противном случае
outcome = результат
outer = внешний
outfit = наряд
outline = контур
output = вывод
outstanding = выдающийся
overall = в целом
overcome = преодолевать
overnight = за ночь
owe = быть должным
ownership = собственность
oxygen = кислород
pace = темп
package = упаковка
packet = пакет
palm = ладонь
panel = панель
panic = паника
parade = парад
parallel = параллельный
parliament = парламент
part-time/adv = неполный рабочий день
participant = участник
participation = участие
partly = частично
partnership = партнёрство
passage = отрывок
passionate = страстный
password = пароль
patch = заплатка
patience = терпение
patient = пациент, терпеливый
pause = пауза
peer = сверстник
penalty = штраф
pension = пенсия
perceive = воспринимать
perception = восприятие
permanent = постоянный
permanently = постоянно
permit = разрешать
perspective = перспектива
pharmacy = аптека
phase = фаза
phenomenon = явление
philosophy = философия
physician = врач
pick = выбирать
picture = картина, изображение
pile = куча
pill = таблетка
pitch = подача
pity = жалость
placement = размещение
plain = простой
plot = сюжет
plus = плюс
pointed = заострённый
popularity = популярность
portion = порция
pose = позировать
position = позиция
positive = положительный
possess = обладать
potential = потенциал
potentially = потенциально
power = сила, власть
praise = хвалить
precede = предшествовать
precious = драгоценный
precise = точный
precisely = точно
predictable = предсказуемый
preference = предпочтение
pregnant = беременная
preparation = подготовка
presence = присутствие
preserve = сохранять
presidential = президентский
price = цена
pride = гордость
primarily = в первую очередь
prime = главный
principal = директор школы
principle = принцип
print = печатать
prior = предшествующий
priority = приоритет
privacy = приватность
probability = вероятность
probable = вероятный
procedure = процедура
proceed = продолжать
process = процесс
produce = производить
professional = профессиональный
programming = программирование
progress = прогресс
progressive = прогрессивный
prohibit = запрещать
project = проект
promising = многообещающий
promotion = продвижение
prompt = подсказка
proof = доказательство
proportion = пропорция
proposal = предложение
propose = предлагать
prospect = перспектива
protection = защита
protein = белок
protester = протестующий
psychological = психологический
psychologist = психолог
psychology = психология
publication = публикация
publicity = публичность
publishing = издательство
punk = панк
pupil = ученик
purchase = покупка
pure = чистый
purely = исключительно
pursue = преследовать
pursuit = стремление
puzzle = головоломка
questionnaire = анкета
racial = расовый
racism = расизм
racist = расист
radiation = радиация
rail = рельс
random = случайный
range = диапазон
rank = ранг
rapid = быстрый
rapidly = быстро
rat = крыса
rate = оценивать, ставка
rating = рейтинг
raw = сырой
reach = достигать
realistic = реалистичный
reasonable = разумный
reasonably = разумно
rebuild = восстанавливать
recall = вспоминать
receiver = получатель
recession = спад
reckon = рассчитывать
recognition = признание
recover = восстанавливаться
recovery = восстановление
recruit = набирать (в армию, компанию)
reduction = сокращение
referee = судья
refugee = беженец
regard = рассматривать
regional = региональный
register = регистрировать
registration = регистрация
regret = сожаление
regulate = регулировать
regulation = регулирование
reinforce = укреплять
relatively = относительно
relevant = уместный
relief = облегчение
relieve = облегчать
relieved = чувствующий облегчение
rely = полагаться
remark = замечание
remarkable = замечательный
remarkably = замечательно
reporting = отчётность
representative = представитель
reputation = репутация
requirement = требование
rescue = спасение
reserve = резервировать
resident = житель
resign = увольняться
resist = сопротивляться
resolution = разрешение (проблемы)
resolve = решать (проблему)
resort = курорт
restore = восстанавливать
restrict = ограничивать
restriction = ограничение
resume = резюме
retail = розничная торговля
retain = сохранять
retirement = выход на пенсию
reveal = раскрывать
revenue = доход
revision = пересмотр
revolution = революция
reward = награда
rhythm = ритм
rid = избавляться
ridiculous = нелепый
risky = рискованный
rival = соперник
rob = грабить
robbery = ограбление
rocket = ракета
romance = романтика
root = корень
rose = роза
roughly = приблизительно
round = круглый
routine = рутина
rub = тереть
rubber = резина
ruin = разрушать
rural = сельский
rush = спешить
sample = образец
satellite = спутник
satisfaction = удовлетворение
satisfied = довольный
satisfy = удовлетворять
saving = сбережения
scale = масштаб
scandal = скандал
scare = пугать
scenario = сценарий
schedule = расписание
scheme = схема
scholar = учёный
scholarship = стипендия
scratch = царапать
scream = кричать
screen = экран
screening = показ
seat = сиденье
sector = сектор
secure = безопасный
seek = искать
seeker = искатель
select = выбирать
selection = выбор
self = сам
seminar = семинар
senior = старший
sense = чувство
sensitive = чувствительный
sentence = предложение
sequence = последовательность
session = сессия
settle = урегулировать
settler = поселенец
severe = серьёзный
severely = сильно
sexy = сексуальный
shade = тень
shadow = тень
shallow = неглубокий
shame = стыд
shape = форма
shaped = сформированный
shelter = укрытие
shift = смена
ship = корабль
shock = шок
shocked = шокированный
shocking = шокирующий
shooting = стрельба
shore = берег
short-term = краткосрочный
shortage = нехватка
shortly = вскоре
shot = выстрел
sibling = брат или сестра
sidewalk = тротуар
signature = подпись
significance = значимость
significant = значительный
significantly = значительно
silence = тишина
silk = шёлк
sincere = искренний
skilled = опытный
skull = череп
slave = раб
slide = скользить
slight = незначительный
slip = скользить
slogan = лозунг
slope = склон
so-called = так называемый
solar = солнечный
somehow = как-то
sometime = когда-нибудь
somewhat = несколько
sophisticated = утончённый
soul = душа
spare = запасной
specialist = специалист
specialise = специализироваться
species = вид
specify = уточнять
spectacular = захватывающий
spectator = зритель
speculate = размышлять
speculation = спекуляция
speed = скорость
spice = специя
spill = проливать
spiritual = духовный
spite = злоба
split = разделять
spoil = портить
spokesman = представитель
spokesperson = пресс-секретарь
spokeswoman = представительница
sponsor = спонсор
sponsorship = спонсорство
spot = место, пятно
spread = распространять
stable = стабильный
stage = сцена
stall = стойло
stance = позиция
stand = стоять
stare = пристально смотреть
starve = голодать
status = статус
steadily = устойчиво
steady = устойчивый
steam = пар
steel = сталь
steep = крутой
step = шаг
sticky = липкий
stiff = жёсткий
stimulate = стимулировать
stock = запас
stream = поток
strengthen = укреплять
stretch = растягивать
strict = строгий
strictly = строго
strike = забастовка
striking = поразительный
stroke = удар
structure = структура
struggle = бороться
stuff = вещи
stunning = потрясающий
subject = предмет
submit = отправлять
subsequent = последующий
subsequently = впоследствии
suburb = пригород
suffering = страдание
sufficient = достаточный
sufficiently = достаточно
sum = сумма
super = супер
surgeon = хирург
surgery = хирургия
surround = окружать
surrounding = окружающий
survey = опрос
survival = выживание
survivor = выживший
suspect = подозревать
suspend = приостанавливать
sustainable = устойчивый
swallow = глотать
swear = клясться
sweep = подметать
switch = переключать
sympathetic = сочувствующий
sympathy = сочувствие
tag = бирка
tale = сказка
tank = танк
tap = кран
target = цель
tear = слеза
technological = технологический
teen = подросток
temple = храм
temporarily = временно
temporary = временный
tendency = склонность
tension = напряжение
term = термин
terminal = терминал
terms = условия
terribly = ужасно
terrify = пугать
territory = территория
terror = ужас
terrorism = терроризм
terrorist = террорист
testing = тестирование
textbook = учебник
theft = кража
therapist = терапевт
therapy = терапия
thesis = тезис
thorough = тщательный
thoroughly = тщательно
threat = угроза
threaten = угрожать
thumb = большой палец
thus = таким образом
time = время
timing = расчет времени
tissue = ткань
title = заголовок
tone = тон
tough = жесткий
tournament = турнир
trace = след
track = трек
trading = торговля
tragedy = трагедия
tragic = трагический
trait = черта
transfer = передача
transform = преобразовывать
transition = переход
transmit = передавать
trap = ловушка
treasure = сокровище
trial = судебный процесс
tribe = племя
trigger = спусковой крючок
trillion = триллион
trip = путешествие
troop = войско
tropical = тропический
trouble = неприятность
truly = действительно
trust = доверие
try = пытаться
tsunami = цунами
tune = мелодия
tunnel = туннель
ultimate = окончательный
ultimately = в конечном счёте
unacceptable = неприемлемый
uncertainty = неопределённость
unconscious = бессознательный
undergo = подвергаться
undertake = предпринимать
unexpected = неожиданный
unfold = разворачиваться
unfortunate = неудачный
unique = уникальный
unite = объединять
unity = единство
universal = универсальный
universe = вселенная
unknown = неизвестный
upper = верхний
upwards = вверх
urban = городской
urge = побуждать
urgent = срочный
usage = использование
useless = бесполезный
valid = действительный
value = ценность
variation = вариация
vary = варьировать
vast = огромный
venue = место встречи
vertical = вертикальный
very = очень
via = через
victory = победа
viewpoint = точка зрения
violence = насилие
virtual = виртуальный
visa = виза
visible = видимый
vision = зрение
visual = визуальный
vital = жизненно важный
vitamin = витамин
volume = объем
voluntary = добровольный
voting = голосование
wage = заработная плата
wander = бродить
warming = потепление
way = путь
weakness = слабость
wealth = богатство
wealthy = богатый
weekly = еженедельный
weird = странный
welfare = благосостояние
wheat = пшеница
whereas = тогда как
wherever = где бы ни
whisper = шептать
whoever = кто бы ни
whom = кого
widely = широко
widespread = широко распространённый
wildlife = дикая природа
willing = готовый
wind = ветер
wire = провод
wisdom = мудрость
wise = мудрый
withdraw = снимать
witness = свидетель
wolf = волк
workforce = рабочая сила
workplace = рабочее место
workshop = мастерская
worm = червь
worse = хуже
worst = худший
worth = стоящий
wound = рана
wrap = заворачивать
wrist = запястье
wrong = неправильный
yet = ещё
zone = зона
