to arm (verb) = вооружать
counter (argue) = возражать
grave (cemetery) = могила
grave (serious) = серьёзный
strip (narrow piece) = полоса
stun (verb) = оглушить, ошеломить
abolish = упразднять
abortion = аборт
absence = отсутствие
absent = отсутствующий
absurd = абсурдный
abuse = злоупотребление, оскорбление
academy = академия
accelerate = ускорять
acceptance = принятие
accessible = доступный
accomplishment = достижение
accordingly = соответственно
accountability = ответственность
accountable = подотчётный
accumulate = накапливать
accumulation = накопление
accusation = обвинение
accused = обвиняемый
acid = кислота
acquisition = приобретение
activation = активация
activist = активист
acute = острый
adaptation = адаптация
adhere = придерживаться
adjacent = прилегающий
adjustment = корректировка
administer = управлять
administrative = административный
administrator = администратор
admission = допуск
adolescent = подросток
adoption = усыновление, принятие
adverse = неблагоприятный
advocate = защитник, адвокат
aesthetic = эстетический
affection = привязанность
aftermath = последствия
aggression = агрессия
agricultural = сельскохозяйственный
aide = помощник
alert = тревога
align = выравнивать
alignment = выравнивание
alike = похожий
allegation = обвинение
allege = утверждать
allegedly = якобы
alliance = союз
allocate = распределять
allocation = распределение
allowance = пособие
ally = союзник
aluminum = алюминий
amateur = любитель
ambassador = посол
amend = вносить поправки
amendment = поправка
amid = среди
analogy = аналогия
anchor = якорь
angel = ангел
anonymous = анонимный
apparatus = аппарат
apparel = одежда
appealing = привлекательный
appetite = аппетит
applaud = аплодировать
applicable = применимый
appoint = назначать
appreciation = признательность
arbitrary = произвольный
architectural = архитектурный
archive = архив
arena = арена
array = массив
articulate = чётко выражать
ash = пепел
aspiration = стремление
aspire = стремиться
assassination = убийство
assault = нападение
assemble = собирать
assembly = собрание
assert = утверждать
assertion = утверждение
assurance = гарантия
asylum = убежище
atrocity = зверство
attain = достигать
attendance = посещаемость
attribute = атрибут
auction = аукцион
audit = проверка
authentic = подлинный
authorize = уполномочивать
auto = автомобиль
autonomy = автономия
autumn = осень
availability = доступность
await = ожидать
backdrop = фон
backing = поддержка
backup = резервное копирование
bail = залог
ballot = бюллетень
bankruptcy = банкротство
banner = баннер
bare = голый
barrel = бочка
bass = бас
battlefield = поле боя
bay = залив
beam = луч
beast = зверь
behalf = от имени
behavioral = поведенческий
beloved = любимый
bench = скамейка
benchmark = эталон
beneath = под
beneficiary = бенефициар
betray = предавать
beverage = напиток
bind = связывать
biography = биография
bishop = епископ
bizarre = странный
blade = лезвие
blast = взрыв
bleed = кровоточить
blend = смешивать
bless = благословлять
blessing = благословение
boast = хвастаться
bonus = бонус
booking = бронирование
boom = бум
bounce = подпрыгивать
boundary = граница
bow = лук (оружие)
breach = нарушение
breakdown = поломка
breakthrough = прорыв
breed = порода
broadband = широкополосный
browser = браузер
brutal = жестокий
buddy = приятель
buffer = буфер
bulk = основная масса
burden = бремя
bureaucracy = бюрократия
burial = погребение
burst = взрываться
cabinet = кабинет
calculation = расчёт
canvas = холст
capability = возможность
capitalism = капитализм
capitalist = капиталист
cargo = груз
carriage = карета
carve = вырезать
casino = казино
casualty = жертва
catalog = каталог
cater = обслуживать
cattle = скот
caution = осторожность
cautious = осторожный
cease = прекращать
cemetery = кладбище
chamber = палата
chaos = хаос
characterise = характеризовать
charm = обаяние
charter = устав
choir = хор
chronic = хронический
chunk = кусок
circulate = циркулировать
circulation = циркуляция
citizenship = гражданство
civic = гражданский
civilian = гражданский (невоенный)
clarity = ясность
clash = столкновение
classification = классификация
cling = цепляться
clinical = клинический
closure = закрытие
cluster = кластер
coalition = коалиция
coastal = прибрежный
cocktail = коктейль
cognitive = познавательный
coincide = совпадать
collaborate = сотрудничать
collaboration = сотрудничество
collective = коллективный
collision = столкновение
colonial = колониальный
columnist = обозреватель
combat = бой
commence = начинать
commentary = комментарий
commentator = комментатор
commerce = торговля
commissioner = комиссар
commodity = товар
communist = коммунист
companion = спутник
comparable = сравнимый
compassion = сострадание
compel = вынуждать
compelling = убедительный
compensate = компенсировать
compensation = компенсация
competence = компетенция
competent = компетентный
compile = компилировать
complement = дополнение
complexity = сложность
compliance = соответствие
complication = осложнение
comply = подчиняться
composition = композиция
compromise = компромисс
compute = вычислять
conceal = скрывать
concede = уступать
conceive = зачать, замышлять
conception = зачатие, концепция
concession = уступка
condemn = осуждать
confer = совещаться
confession = признание
configuration = конфигурация
confine = ограничивать
confirmation = подтверждение
confront = противостоять
confrontation = противостояние
congratulate = поздравлять
congregation = собрание
congressional = относящийся к конгрессу
conquer = завоёвывать
conscience = совесть
consciousness = сознание
consecutive = последовательный
consensus = консенсус
consent = согласие
conserve = сохранять
consistency = последовательность
consolidate = укреплять
constitute = составлять
constitution = конституция
constitutional = конституционный
constraint = ограничение
consultation = консультация
contemplate = обдумывать
contempt = презрение
contend = бороться
contender = претендент
content = содержание
contention = спор
continually = непрерывно
contractor = подрядчик
contradiction = противоречие
contrary = противоположный
contributor = вкладчик
conversion = преобразование
convict = осуждённый
conviction = убеждение
cooperate = сотрудничать
cooperative = кооперативный
coordinate = координировать
coordination = координация
coordinator = координатор
copper = медь
copyright = авторское право
correction = исправление
correlate = соотносить
correlation = корреляция
correspond = соответствовать
correspondence = переписка
correspondent = корреспондент
corresponding = соответствующий
corrupt = коррумпированный
corruption = коррупция
costly = дорогостоящий
councilor = советник
counseling = консультирование
counselor = консультант
counterpart = аналог
countless = бесчисленный
coup = государственный переворот
courtesy = учтивость
craft = ремесло
crawl = ползать
creator = создатель
credibility = доверие
credible = заслуживающий доверия
creep = ползти
critique = критика
crown = корона
crude = сырой
crush = раздавливать
crystal = кристалл
cult = культ
cultivate = культивировать
curiosity = любопытство
custody = опека

cutting = резка
cynical = циничный
dam = плотина
damaging = наносящий ущерб
dawn = рассвет
debris = обломки
debut = дебют
decision-making = принятие решений
decisive = решительный
declaration = декларация
dedicated = преданный
dedication = преданность
deed = поступок
deem = считать
default = по умолчанию
defect = дефект
defensive = оборонительный
deficiency = дефицит
deficit = недостаток
defy = бросать вызов
delegate = делегат
delegation = делегация
delicate = деликатный
demon = демон
denial = отрицание
denounce = осуждать
dense = плотный
density = плотность
dependence = зависимость
depict = изображать
deploy = развертывать
deployment = развертывание
deprive = лишать
deputy = заместитель
descend = спускаться
descent = спуск
designate = назначать
desirable = желаемый
desktop = настольный
destructive = разрушительный
detain = задерживать
detection = обнаружение
detention = задержание
deteriorate = ухудшаться
devastate = опустошать
devil = дьявол
devise = разрабатывать
diagnose = диагностировать
diagnosis = диагноз
dictate = диктовать
dictator = диктатор
differentiate = различать
dignity = достоинство
dilemma = дилемма
dimension = измерение
diminish = уменьшать
dip = окунать
diplomat = дипломат
diplomatic = дипломатический
directory = каталог
disastrous = катастрофический
discard = отбрасывать
discharge = разряд
disclose = раскрывать
disclosure = раскрытие
discourse = дискурс
discretion = усмотрение
discrimination = дискриминация
dismissal = увольнение
displace = вытеснять
disposal = удаление
dispose = избавляться
dispute = спор
disrupt = нарушать
disruption = нарушение
dissolve = растворять
distinction = различие
distinctive = отличительный
distort = искажать
distress = страдание
disturbing = тревожный
divert = отвлекать
divine = божественный
doctrine = доктрина
documentation = документация
domain = область
dominance = доминирование
donor = донор
dose = доза
drain = дренаж
drift = дрейф
driving = вождение
drown = тонуть
dual = двойной
dub = дублировать
dumb = глупый
duo = дуэт
earnings = заработок
ease = лёгкость
echo = эхо
ecological = экологический
educator = педагог
effectiveness = эффективность
efficiency = продуктивность
ego = эго
elaborate = детализировать
electoral = избирательный
elevate = поднимать
eligible = имеющий право
elite = элита
embark = начинать
embarrassment = смущение
embassy = посольство
embed = встраивать
embody = воплощать
emergence = появление
empirical = эмпирический
empower = наделять полномочиями
enact = вводить в действие
encompass = охватывать
encouragement = поощрение
encouraging = обнадёживающий
endeavor = стремление
endless = бесконечный
endorse = поддерживать
endorsement = одобрение
endure = терпеть
enforce = приводить в исполнение
enforcement = обеспечение
engagement = участие
engaging = увлекательный
enrich = обогащать
enroll = зачислять
ensue = следовать
enterprise = предприятие
enthusiast = энтузиаст
entitle = давать право
entity = сущность
epidemic = эпидемия
equality = равенство
equation = уравнение
erect = возводить
escalate = обострять
essence = суть
establishment = учреждение
eternal = вечный
evacuate = эвакуировать
evoke = вызывать
evolutionary = эволюционный
exaggerate = преувеличивать
excellence = превосходство
exceptional = исключительный
excess = избыток
exclusion = исключение
exclusive = эксклюзивный
exclusively = исключительно
execute = выполнять
execution = исполнение
exert = оказывать давление
exile = изгнание
expenditure = расход
experimental = экспериментальный
expire = истекать
explicit = явный
explicitly = ясно
exploitation = эксплуатация
explosive = взрывчатый
extremist = экстремист
facilitate = способствовать
faction = фракция
fade = увядать
fairness = справедливость
fatal = смертельный
fate = судьба
favorable = благоприятный
feat = подвиг
felony = тяжкое преступление
feminist = феминистка
fiber = волокно
fierce = свирепый
filmmaker = режиссёр
filter = фильтр
fine = штраф, тонкий
firearm = огнестрельное оружие
fiscal = фискальный
fit = подходить
flaw = изъян
flawed = с изъяном
flee = убегать
fleet = флот
flesh = плоть
flexibility = гибкость
flourish = процветать
fluid = жидкость
footage = видеоматериал
foreigner = иностранец
forge = ковать
formula = формула
formulate = формулировать
forth = вперёд
forthcoming = предстоящий
foster = поощрять
fragile = хрупкий
franchise = франшиза
frankly = откровенно
freshman = первокурсник
frustrated = разочарованный
frustrating = разочаровывающий
frustration = разочарование
functional = функциональный
fundraising = сбор средств
funeral = похороны
gambling = азартные игры
gathering = собрание
gaze = пристально смотреть
gear = механизм
generic = общий
genocide = геноцид
gig = концерт
glance = взгляд
glimpse = проблеск
glorious = славный
glory = слава
governance = управление
grace = грация
grasp = схватывать
gravity = гравитация
grid = сеть
grief = горе
grin = ухмылка
grind = молоть
grip = хватка
gross = грубый, валовой
guerrilla = партизан
guidance = руководство
guilt = вина
gut = кишечник
hail = град
halfway = на полпути
halt = остановка
handful = горсть
handling = обращение
handy = удобный
harassment = домогательство
hardware = оборудование
harmony = гармония
harsh = суровый
harvest = урожай
hatred = ненависть
haunt = преследовать
hazard = опасность
heighten = повышать
heritage = наследие
hierarchy = иерархия
high-profile = громкий (о деле)
hint = намёк
homeland = родина
hopeful = обнадёживающий
horizon = горизонт
horn = рог
hostage = заложник
hostile = враждебный
hostility = враждебность
humanitarian = гуманитарный
humanity = человечество
humble = скромный
hydrogen = водород
identification = идентификация
ideological = идеологический
ideology = идеология
idiot = идиот
ignorance = невежество
imagery = образы
immense = огромный
imminent = неизбежный
implementation = внедрение
imprison = заключать в тюрьму
inability = неспособность
inadequate = недостаточный
inappropriate = неуместный
incarcerate = заключать в тюрьму
incarceration = тюремное заключение
incidence = частота
inclined = склонный
inclusion = включение
incur = навлечь
indicator = индикатор
indictment = обвинительное заключение
indigenous = коренной
induce = вызывать
indulge = потакать
inequality = неравенство
infamous = печально известный
infant = младенец
infect = заражать
inflict = наносить
influential = влиятельный
inherent = присущий
inhibit = подавлять
initiate = начинать
inject = вводить (инъекцию)
injection = инъекция
injustice = несправедливость
inmate = заключённый
inquire = спрашивать
insertion = вставка
insider = инсайдер
inspect = осматривать
inspection = осмотр
inspiration = вдохновение
instinct = инстинкт
institutional = институциональный
instruct = инструктировать
instrumental = важный
insufficient = недостаточный
insult = оскорбление
intact = неповреждённый
intake = потребление
integral = неотъемлемый
integrated = интегрированный
integration = интеграция
integrity = целостность
intensify = усиливать
intensity = интенсивность
intensive = интенсивный
intent = намерение
interactive = интерактивный
interface = интерфейс
interfere = вмешиваться
interference = вмешательство
interim = временный
interior = интерьер
intermediate = промежуточный
intersection = перекрёсток
intervene = вмешиваться
intervention = вмешательство
intimate = интимный
intriguing = интригующий
inventory = инвентарь
investigator = следователь
invisible = невидимый
invoke = вызывать
involvement = участие
ironic = ироничный
ironically = иронично
irony = ирония
irrelevant = неуместный
isolation = изоляция
judicial = судебный
jurisdiction = юрисдикция
just = справедливый
justification = оправдание
keen = увлечённый
kidnap = похищать
kidney = почка
kingdom = королевство
landlord = арендодатель
landmark = ориентир
lap = круг
large-scale = крупномасштабный
laser = лазер
latter = последний (из двух)
lawmaker = законодатель
lawn = газон
lawsuit = иск
layout = макет
leak = утечка
leap = прыжок
legacy = наследие
legendary = легендарный
legislation = законодательство
legislative = законодательный
legislature = законодательный орган
legitimate = законный
lengthy = длительный
lesbian = лесбиянка
lesser = меньший
lethal = смертельный
liable = ответственный
liberal = либеральный
liberation = освобождение
liberty = свобода
lifelong = пожизненный
likelihood = вероятность
limb = конечность
linear = линейный
lineup = состав
linger = задерживаться
listing = список
liter = литр
literacy = грамотность
liver = печень
lobby = лобби
log = журнал, бревно
logic = логика
long-standing = давний
longtime = долгий
loom = виднеться
loop = петля
loyalty = лояльность
machinery = оборудование
magical = магический
magnetic = магнитный
magnitude = величина
mainland = материк
mainstream = основное направление
maintenance = обслуживание
mandate = мандат
mandatory = обязательный
manifest = проявлять
manipulate = манипулировать
manipulation = манипуляция
manuscript = рукопись
march = марш
marginal = незначительный
marine = морской
marketplace = рынок
mask = маска
massacre = резня
mathematical = математический
mature = зрелый
maximize = максимизировать
meaningful = значимый
meantime = тем временем
medieval = средневековый
meditation = медитация
melody = мелодия
memo = памятка
memoir = мемуары
memorial = мемориал
mentor = наставник
merchant = торговец
mercy = милосердие
mere = всего лишь
merely = просто
merge = сливать
merger = слияние
merit = заслуга
methodology = методология
midst = середина
migration = миграция
militant = боевик
militia = ополчение
mill = мельница
minimal = минимальный
minimize = минимизировать
mining = добыча
ministry = министерство
minute = минута
miracle = чудо
misery = страдание
misleading = вводящий в заблуждение
missile = ракета
mob = толпа
mobile = мобильный
mobility = подвижность
mobilize = мобилизовать
moderate = умеренный
modification = модификация
module = модуль
momentum = импульс
monk = монах
monopoly = монополия
morality = мораль
motive = мотив
municipal = муниципальный
mutual = взаимный
namely = а именно
nationwide = общенациональный
naval = военно-морской
neglect = пренебрегать
neighboring = соседний
nest = гнездо
net = сеть
newsletter = новостная рассылка
niche = ниша
noble = благородный
nod = кивать
nominate = выдвигать
nomination = номинация
nominee = кандидат
nonetheless = тем не менее
nonprofit = некоммерческий
nonsense = чепуха
noon = полдень
notable = заметный
notably = особенно
notify = уведомлять
notorious = печально известный
novel = роман
nursery = детская
objection = возражение
oblige = обязывать
obsess = преследовать (мысли)
obsession = навязчивая идея
occasional = случайный
occurrence = событие
odds = шансы
offering = предложение
offspring = потомство
operational = операционный
opt = выбирать
optical = оптический
optimism = оптимизм
oral = устный
organisational = организационный
orientation = ориентация
originate = происходить
outbreak = вспышка
outing = прогулка
outlet = выход
outlook = перспектива
outrage = возмущение
outsider = посторонний
overlook = упускать из виду
overly = чрезмерно
oversee = надзирать
overturn = опрокидывать
overwhelm = ошеломлять
overwhelming = подавляющий
pad = блокнот, подушечка
parameter = параметр
parental = родительский
parliament = парламент
partial = частичный
partially = частично
passing = прохождение
passive = пассивный
pastor = пастор
patent = патент
pathway = путь
patrol = патруль
patron = покровитель
peak = пик
peasant = крестьянин
peculiar = своеобразный
pension = пенсия
persist = упорствовать
persistent = настойчивый
personnel = персонал
petition = петиция
philosopher = философ
philosophical = философский
pioneer = пионер
pipeline = трубопровод
pirate = пират
pit = яма
plea = мольба
plead = умолять
pledge = обещание
plug = вилка, пробка
plunge = погружаться
pole = столб, полюс
poll = опрос
pond = пруд
pop = хлопок, популярный
portfolio = портфель
portray = изображать
postpone = откладывать
postwar = послевоенный
practitioner = практикующий специалист
preach = проповедовать
precedent = прецедент
precision = точность
predator = хищник
predecessor = предшественник
predominantly = преимущественно
pregnancy = беременность
prejudice = предвзятость
preliminary = предварительный
premier = премьер
premise = предпосылка
premium = премия
prescribe = прописывать
prescription = рецепт (медицинский)
presently = в настоящее время
preservation = сохранение
preside = председательствовать
presidency = президентство
prestigious = престижный
presumably = предположительно
presume = предполагать
prevail = преобладать
prevalence = распространённость
prevention = предотвращение
prey = добыча
privatization = приватизация
privilege = привилегия
probe = расследование
problematic = проблемный
proceeding = процесс
proceeds = доходы
processing = обработка
processor = процессор
proclaim = провозглашать
productive = продуктивный
productivity = производительность
profitable = прибыльный
profound = глубокий
projection = прогноз
prominent = видный
pronounced = ярко выраженный
propaganda = пропаганда
proposition = предложение
prosecute = преследовать (по закону)
prosecution = обвинение
prosecutor = прокурор
prospective = перспективный
prosperity = процветание
protective = защитный
protocol = протокол
province = провинция
provincial = провинциальный
provision = положение
provoke = провоцировать
psychiatric = психиатрический
pulse = пульс
pump = насос
punch = удар
query = запрос
quest = поиски
quota = квота
radar = радар
radical = радикальный
rage = ярость
raid = налёт
rally = митинг
ranking = рейтинг
rape = изнасилование
ratio = соотношение
rational = рациональный
ray = луч
readily = легко
realization = осознание
realm = царство
rear = задняя часть
reasoning = рассуждение
reassure = успокаивать
rebel = мятежник
rebellion = восстание
recipient = получатель
reconstruction = реконструкция
recount = пересказ
recruitment = набор
referendum = референдум
reflection = отражение
reform = реформа
refuge = убежище
refusal = отказ
regain = вернуть
regardless = несмотря на
regime = режим
regulator = регулятор
regulatory = регулирующий
rehabilitation = реабилитация
reign = правление
rejection = отказ
relevance = уместность
reliability = надёжность
reluctant = неохотный
remainder = остаток
remains = останки
remedy = средство
reminder = напоминание
removal = удаление
render = оказывать
renew = обновлять
renowned = известный
rental = аренда
replacement = замена
reportedly = по сообщениям
representation = представительство
reproduce = воспроизводить
reproduction = воспроизведение
republic = республика
resemble = напоминать
reside = проживать
residence = проживание
residential = жилой
residue = остаток
resignation = отставка
resistance = сопротивление
respective = соответствующий
respectively = соответственно
restoration = восстановление
restraint = сдержанность
resume = возобновлять
retreat = отступление
retrieve = извлекать
revelation = откровение
revenge = месть
reverse = обратный
revival = возрождение
revive = возрождать
revolutionary = революционный
rhetoric = риторика
rifle = винтовка
riot = беспорядки
rip = рвать
ritual = ритуал
robust = крепкий
rock = камень, рок
rod = стержень
rookie = новичок
roster = список
rotate = вращать
rotation = ротация
ruling = постановление
rumour = слух
sacred = священный
sacrifice = жертва
saint = святой
sake = ради
sanction = санкция
say = сказать
scattered = разбросанный
scope = сфера
screw = винт
scrutiny = внимательное изучение
seal = печать
secondly = во-вторых
secular = светский
seemingly = по-видимому
segment = сегмент
seize = захватывать
seldom = редко
selective = избирательный
sensation = ощущение
sensitivity = чувствительность
sentiment = чувство
separation = разделение
serial = серийный
settlement = поселение
setup = установка
sexuality = сексуальность
shareholder = акционер
shatter = разбивать
shed = проливать
sheer = абсолютный
shipping = доставка
shoot = стрелять
shrink = сжиматься
shrug = пожимать плечами
sigh = вздыхать
simulate = имитировать
simulation = моделирование
simultaneously = одновременно
sin = грех
situated = расположенный
skeptical = скептический
sketch = набросок
skip = пропускать
slam = захлопывать
slap = пощечина
slash = сокращать
slavery = рабство
slot = слот
smash = разбивать
snap = щелкать
soak = замачивать
soar = взлетать
socialist = социалист
sole = единственный
solely = исключительно
solidarity = солидарность
solo = сольный
sophomore = студент второго курса
sound = звук
sovereignty = суверенитет
spam = спам
span = промежуток
spark = искра
specialized = специализированный
specification = спецификация
specimen = образец
spectacle = зрелище
spectrum = спектр
spell = заклинание, период
sphere = сфера
spin = вращаться
spine = позвоночник
spotlight = прожектор
spouse = супруг(а)
spy = шпион
squad = отряд
squeeze = сжимать
stab = удар ножом
stability = стабильность
stabilize = стабилизировать
stake = доля
standing = положение
stark = суровый
statistical = статистический
steer = направлять
stem = стебель
stereotype = стереотип
stimulus = стимул
stir = размешивать
storage = хранение
straightforward = прямолинейный
strain = напряжение
strand = прядь
strategic = стратегический
strive = стремиться
structural = структурный
stumble = спотыкаться
submission = подчинение
subscriber = подписчик
subscription = подписка
subsidy = субсидия
substantial = существенный
substantially = значительно
substitute = замена
substitution = замещение
subtle = тонкий, неуловимый
suburban = пригородный
succession = преемственность
successive = последовательный
successor = преемник
suck = сосать
sue = подавать в суд
suicide = самоубийство
suite = номер (в отеле)
summit = вершина, саммит
superb = превосходный
superintendent = управляющий
superior = превосходящий
supervise = контролировать
supervision = надзор
supervisor = руководитель
supplement = добавка
supportive = поддерживающий
supposedly = предположительно
suppress = подавлять
supreme = верховный
surge = всплеск
surgical = хирургический
surplus = излишек
surrender = сдаваться
surveillance = наблюдение
suspension = приостановка
suspicion = подозрение
suspicious = подозрительный
sustain = поддерживать
swing = качаться
sword = меч
symbolic = символический
syndrome = синдром
synthesis = синтез
systematic = систематический
tackle = решать (вопрос)
tactic = тактика
tactical = тактический
taxpayer = налогоплательщик
tempt = искушать
tenant = арендатор
tender = тендер, нежный
tenure = срок пребывания в должности
terminate = завершать
terrain = местность
terrific = потрясающий
testify = свидетельствовать
testimony = показание
texture = текстура
thankfully = к счастью
theatrical = театральный
theology = теология
theoretical = теоретический
thereafter = после этого
thereby = таким образом
thoughtful = задумчивый
thread = нить
threshold = порог
thrilled = в восторге
thrive = процветать
tide = прилив
tighten = затягивать
timber = древесина
timely = своевременный
tobacco = табак
tolerance = толерантность
tolerate = терпеть
toll = плата
top = верх, вершина
torture = пытка
toss = бросать
total = общий
toxic = токсичный
trademark = товарный знак
trail = след
trailer = прицеп
transaction = сделка
transcript = стенограмма
transformation = преобразование
transit = транзит
transmission = передача
transparency = прозрачность
transparent = прозрачный
trauma = травма
treaty = договор
tremendous = огромный
tribal = племенной
tribute = дань
trio = трио
triumph = триумф
trophy = трофей
troubled = обеспокоенный
trustee = попечитель
tuition = обучение
tumor = опухоль
turnout = явка (на выборы)
turnover = товарооборот
twist = поворот
unconstitutional = противоречащий конституции
undergraduate = студент
underlying = лежащий в основе
undermine = подрывать
undoubtedly = несомненно
unify = объединять
unprecedented = беспрецедентный
unveil = раскрывать
upcoming = предстоящий
upgrade = обновление
uphold = поддерживать
utility = полезность
utilize = использовать
utterly = крайне
vacuum = вакуум
vague = расплывчатый
validity = действительность
vanish = исчезать
variable = переменный
varied = разнообразный
vein = вена
venture = предприятие
verbal = устный
verdict = вердикт
verify = проверять
verse = стих
versus = против
vessel = сосуд
veteran = ветеран
viable = жизнеспособный
vibrant = яркий
vice = порок
vicious = злобный
violate = нарушать
violation = нарушение
virtue = добродетель
vocal = голосовой
vow = клятва
vulnerability = уязвимость
vulnerable = уязвимый
ward = палата, опекаемый
warehouse = склад
warfare = военные действия
warrant = ордер
warrior = воин
weaken = ослаблять
weave = ткать
weed = сорняк
well = колодец
well-being = благополучие
whatsoever = вообще
whereby = посредством чего
whip = хлыст, взбивать
wholly = полностью
widen = расширять
widow = вдова
width = ширина
willingness = готовность
wipe = вытирать
wit = остроумие
withdrawal = вывод
workout = тренировка
worship = поклонение
worthwhile = стоящий
worthy = достойный
yell = кричать
yield = приносить, уступать
