awfully = ужасно
bypass = обход
cynical = циничный
dynasty = династия
eyelid = веко
furnace = печь
gulf = залив
hypocrisy = лицемерие
irritation = раздражение
justified = оправданный
knob = ручка (двери)
lyric = лирика
mystic = мистик
overthrow = свержение
questioning = допрос
Russia = Россия
systematically = систематически
twelfth = двенадцатый
utopia = утопия
voluntarily = добровольно
wrinkle = морщина
youthful = юный
zeal = рвение
abdomen = живот
above all = прежде всего
above-mentioned = вышеупомянутый
abstain = воздерживаться
acceleration = ускорение
accentuate = акцентировать
accepted = принятый
accessibility = доступность
accessory = аксессуар
accidentally = случайно
acclaimed = признанный
accredit = аккредитовать
accreditation = аккредитация
accustomed = привыкший
acknowledgement = признание
acoustic = акустический
acquit = оправдать
activation = активация
add up = складывать
addiction = зависимость
additionally = дополнительно
adhere = придерживаться
adore = обожать
affordable = доступный
Africa = Африка
after all = в конце концов
aggregate = совокупность
algorithm = алгоритм
align = выравнивать
allergy = аллергия
alleviate = облегчать
allot = выделять
allotment = выделение
amenity = удобство
amusing = забавный
analytical = аналитический
anecdote = анекдот
animated = анимационный
animation = анимация
annum = год (в латинских терминах)
anomaly = аномалия
antenna = антенна
antiquity = древность
any more = больше
apostle = апостол
apprentice = ученик
approx = приблизительно
apricot = абрикос
aquarium = аквариум
arabic = арабский
archaeological = археологический
archbishop = архиепископ
arguably = возможно
armed forces = вооружённые силы
artefact = артефакт
ashtray = пепельница
asphalt = асфальт
atheist = атеист
atmospheric = атмосферный
attentive = внимательный
aubergine = баклажан
audio = аудио
austrian = австрийский
authorisation = авторизация
authorship = авторство
awesome = потрясающий
baked beans = печёные бобы
bandit = бандит
baptise = крестить
baptism = крещение
Baptist = баптист
basics = основы
battalion = батальон
be about to = собираться
bearing = подшипник
beetle = жук
believe in = верить в
betrayal = предательство
bibliography = библиография
bilateral = двусторонний
bingo = бинго
bitterness = горечь
bleeding = кровотечение
blog = блог
blogger = блоггер
boredom = скука
borough = район
bra = бюстгальтер
breakthrough = прорыв
briefing = брифинг
brightness = яркость
bring back = вернуть
bring in = вводить
broadband = широкополосный
broaden = расширять
broccoli = брокколи
brother-in-law = шурин
brutal = жестокий
build up = накапливать
bully = хулиган
bum = бродяга
bungalow = бунгало
bureaucratic = бюрократический
buying = покупка
calm down = успокаиваться
camel = верблюд
cancellation = отмена
candidacy = кандидатура
cannon = пушка
capital letter = заглавная буква
capitalistic = капиталистический
cardinal = кардинальный
catastrophe = катастрофа
catch up = догонять
cd = компакт-диск
celebrated = знаменитый
celery = сельдерей
cellular = клеточный
censorship = цензура
certification = сертификация
challenging = сложный
charitable = благотворительный
cheer up = подбадривать
chess = шахматы
childcare = уход за детьми
childish = детский
chronicle = хроника
civilisation = цивилизация
claw = коготь
clean up = убирать
cleanliness = чистота
climate change = изменение климата
clown = клоун
cock = петух
coconut = кокос
cod = треска
collaborative = совместный
collaborator = соавтор
collide = сталкиваться
come across = натолкнуться
come back = вернуться
come on = давай!
come out = выходить
come round = прийти в себя
come true = сбываться
come up = появляться
comfortably = комфортно
commend = хвалить
committed = преданный
compatriot = соотечественник
compelling = убедительный
competitiveness = конкурентоспособность
compilation = сборник
complement = дополнять
complementary = взаимодополняющий
compliment = комплимент
composed = сдержанный
comprehend = понимать
comrade = товарищ
con = обманывать
confidentiality = конфиденциальность
configure = настраивать
confiscation = конфискация
congratulation = поздравление
congratulations = поздравления
connected = связанный
conquest = завоевание
consciously = осознанно
console = утешать
consultancy = консалтинг
contamination = загрязнение
contradict = противоречить
convene = созывать
cordial = сердечный
cork = пробка
correspondingly = соответственно
cosy = уютный
counteract = противодействовать
courgette = кабачок
coursework = курсовая работа
craftsman = ремесленник
crap = ерунда
creativity = креативность
creator = создатель
criminality = преступность
critically = критически
crooked = кривой
crow = ворона
crumb = крошка
cue = сигнал
culinary = кулинарный
culminate = завершаться
culprit = виновник
cultivation = культивирование
cunning = хитрый
cut off = отрезать
cycling = езда на велосипеде
daft = глупый
daughter-in-law = невестка
dealings = дела
deceive = обманывать
dedicated = преданный
dedication = преданность
deduction = вычет
deepen = углублять
defender = защитник
definitive = окончательный
deity = божество
deliberation = обсуждение
demo = демо
denominate = называть
dependence = зависимость
deployment = развертывание
deserving = достойный
designation = обозначение
destine = предназначать
detach = отделять
detachment = отряд
detest = ненавидеть
deviation = отклонение
diagnostic = диагностический
dialect = диалект
dice = кости (игральные)
dictator = диктатор
dictatorship = диктатура
didactic = дидактический
dignified = достойный
dignity = достоинство
diligently = старательно
diocese = епархия
diplomacy = дипломатия
disadvantaged = обделённый
disappearance = исчезновение
disassemble = разбирать
disciple = ученик
disconnect = отключать
discretion = усмотрение
disgusting = отвратительный
dispense = распределять
disregard = игнорировать
disseminate = распространять
dissertation = диссертация
dissolution = роспуск
distrust = недоверие
ditch = канава
do up = ремонтировать
do without = обходиться без
doctorate = докторская степень
dodge = уворачиваться
domicile = место жительства
donkey = осёл
dove = голубь
drastic = радикальный
earthly = земной
eat out = поесть вне дома
ecological = экологический
ecologist = эколог
ecology = экология
empower = наделять полномочиями
end up = оказаться
energetic = энергичный
Englishman = англичанин
enhancement = улучшение
enrich = обогащать
enthusiast = энтузиаст
entirety = целостность
entrepreneurship = предпринимательство
entrust = доверять
epic = эпический
epoch = эпоха
erotic = эротический
err = ошибаться
escort = сопровождать
esteem = уважение
eternally = вечно
eternity = вечность
ethic = этика
every other = каждый второй
ex = бывший
exaggeration = преувеличение
excavation = раскопки
excellence = превосходство
exceptionally = исключительно
exclamation mark = восклицательный знак
excursion = экскурсия
excuse me = извините
expressly = прямо, явно
expulsion = изгнание
extraction = добыча
facilitation = содействие
fairy tale = сказка
fall apart = разваливаться
fall asleep = засыпать
fall out = ссориться
fall over = упасть
farewell = прощание
fart = пукать
fascism = фашизм
fascist = фашист
father-in-law = тесть/свекор
fellowship = товарищество
festive = праздничный
fill up = заправлять
filthy = грязный
find out = узнать
finish off = завершить
finish up = заканчивать
finnish = финский
fire engine = пожарная машина
fit in = вписываться
fluctuation = колебание
folder = папка
font = шрифт
footage = видеоматериал
forefront = передний план
foresee = предвидеть
forestall = предупреждать
forgiveness = прощение
fortress = крепость
foul = фол, грязный
fragrance = аромат
frank = откровенный
frosty = морозный
frustrating = разочаровывающий
fulfilment = исполнение
fungus = грибок
gateway = ворота
gem = драгоценный камень
generic = общий
genetically = генетически
genocide = геноцид
get on = ладить
get over = преодолевать
get round to = добраться до
get up to = заняться
gigantic = гигантский
ginger = имбирь
git = придурок
give birth = рожать
gladly = с радостью
glaze = глазурь
global warming = глобальное потепление
go ahead = продолжать
go over = просматривать
go through = проходить через
goddess = богиня
goodnight = спокойной ночи
governance = управление
graceful = грациозный
grandparents = бабушка и дедушка
granny = бабушка
grapefruit = грейпфрут
graveyard = кладбище
gravy = подливка
grove = роща
habitual = привычный
hack = взламывать
hairdresser = парикмахер
hairy = волосатый
hand out = раздавать
hand over = передавать
hard-working = трудолюбивый
hare = заяц
hasten = торопиться
have sex = заниматься сексом
have to = должен
hazardous = опасный
healing = исцеление
hear from = получать известия от
hear of = слышать о
heated = подогретый
heater = обогреватель
heavenly = небесный
help out = помочь
henceforth = отныне
hesitation = колебание
homosexuality = гомосексуальность
honorary = почетный
hoof = копыто
hopeless = безнадежный
hospitable = гостеприимный
hot chocolate = горячий шоколад
how many = сколько (исчисляемые)
how much = сколько (неисчисляемые)
hugely = в огромной степени
humanitarian = гуманитарный
hunter = охотник
hurriedly = поспешно
hygiene = гигиена
icon = икона
idol = идол
if only = если бы только
ignorant = невежественный
imaging = изображение
imbalance = дисбаланс
immortal = бессмертный
impede = препятствовать
imperialism = империализм
impossibility = невозможность
in addition = в дополнение
in charge = ответственный за
in detail = подробно
in total = в общей сложности
inaugurate = вводить в должность
inauguration = инаугурация
incidentally = кстати
inclination = склонность
inclusive = включающий
inconvenience = неудобство
inconvenient = неудобный
indifference = безразличие
indifferent = равнодушный
individuality = индивидуальность
induction = введение
informative = информативный
informed = осведомленный
injustice = несправедливость
innumerable = бесчисленный
inscription = надпись
insertion = вставка
insignificant = незначительный
inspiring = вдохновляющий
interest rate = процентная ставка
interlocutor = собеседник
internally = внутренне
internationally = на международном уровне
interpreter = переводчик
interrogation = допрос
intersection = перекресток
introductory = вводный
intuition = интуиция
invoice = счет
iranian = иранский
iraq = Ирак
ironic = ироничный
irregular = нерегулярный
jealousy = зависть
jelly = желе
jogging = бег трусцой
jointly = совместно
jolly = веселый
journalistic = журналистский
justifiable = оправданный
kangaroo = кенгуру
keep on = продолжать
keep up = поддерживать
kidnap = похищать
kidnapping = похищение
kilo = килограмм
kiosk = киоск
landmark = ориентир
lantern = фонарь
laptop = ноутбук
last night = вчера вечером
lasting = длительный
lastly = наконец
laugh at = смеяться над
lawful = законный
leave out = упускать
leek = лук-порей
legality = законность
legislator = законодатель
legitimacy = легитимность
lengthen = удлинять
let down = подводить
let off = отпускать
lettuce = салат-латук
lever = рычаг
levy = налог
liar = лжец
licensing = лицензирование
liquidate = ликвидировать
liquidation = ликвидация
literal = буквальный
live together = жить вместе
logically = логически
loneliness = одиночество
long-lasting = долговечный
longing = тоска
loo = туалет
look into = расследовать
look round = оглядываться
look up = искать (информацию)
luckily = к счастью
luminous = светящийся
lust = похоть
luxurious = роскошный
madness = безумие
mafia = мафия
magical = волшебный
mail box = почтовый ящик
make into = превращать
make love = заниматься любовью
make up = мириться, выдумывать
make up for = компенсировать
man-made = искусственный
managerial = управленческий
manoeuvre = маневр
mapping = картография
margarine = маргарин
maritime = морской
marker = маркер
marking = маркировка
masculine = мужской
mask = маска
massacre = резня
mast = мачта
masterpiece = шедевр
maternal = материнский
maximal = максимальный
mayonnaise = майонез
meaningless = бессмысленный
mediator = посредник
meet with = встретиться с
membrane = мембрана
memorial = мемориал
mentality = менталитет
mentor = наставник
mess around = баловаться
mess up = испортить
messenger = посланник
messy = грязный
metallic = металлический
metropolis = мегаполис
Mexican = мексиканский
milestone = важный этап
militant = боевик
millennium = тысячелетие
mince = фарш
ministerial = министерский
minutes = протокол
misfortune = несчастье
misty = туманный
misunderstanding = недоразумение
mobilise = мобилизовать
mock = насмехаться
modernisation = модернизация
moist = влажный
mortal = смертный
mother-in-law = свекровь/теща
moustache = усы
move out = выезжать
multitude = множество
naïve = наивный
nag = пилить, ворчать
naive = наивный
name after = назвать в честь
narrate = рассказывать
naughty = непослушный
navigate = ориентироваться
navigation = навигация
Nazi = нацист
negatively = отрицательно
networking = создание сети
Never mind. = Неважно.
new year = Новый год
nibble = грызть
non-existent = несуществующий
not bad = неплохо
notification = уведомление
nought = ноль
novelty = новинка
novice = новичок
now and then = время от времени
obligatory = обязательный
observance = соблюдение
obsession = одержимость
occupational = профессиональный
olive oil = оливковое масло
on the contrary = напротив
on the whole = в целом
on top = наверху
oneself = себя
onset = начало
openness = открытость
oppression = угнетение
optics = оптика
optimal = оптимальный
orderly = аккуратный
ordinance = постановление
orphan = сирота
outburst = вспышка
outing = прогулка
overtake = обгонять
packaging = упаковка
packed = забитый, полный
pact = пакт
painter = художник
paperback = мягкая обложка
paradigm = парадигма
paradox = парадокс
pass on = передать
pass round = раздавать
pathetic = жалкий
pathology = патология
pathway = путь
patiently = терпеливо
patio = внутренний дворик
patriotic = патриотический
pedagogical = педагогический
pending = в ожидании
penguin = пингвин
peninsula = полуостров
perfection = совершенство
periodically = периодически
perpetrator = преступник
persecute = преследовать
persecution = преследование
pessimistic = пессимистичный
petroleum = нефть
pharmaceutical = фармацевтический
phrasal verb = фразовый глагол
pick up = подбирать
picturesque = живописный
pinch = щепотка, ущипнуть
pineapple = ананас
pious = благочестивый
pirate = пират
pitiful = жалкий
plum = слива
poetic = поэтический
point out = указывать
pointer = указатель
ponder = обдумывать
portal = портал
Portuguese = португальский
post box = почтовый ящик
postal = почтовый
prat = глупец
precondition = предпосылка
prefecture = префектура
preferably = желательно
premiere = премьера
premise = предпосылка
preparedness = готовность
prerequisite = необходимое условие
prestigious = престижный
preventive = профилактический
preview = предварительный просмотр
pricing = ценообразование
private life = личная жизнь
privatisation = приватизация
procurement = закупка
progression = прогресс
prohibition = запрет
promotional = рекламный
promptly = быстро, незамедлительно
prophet = пророк
prosper = процветать
prostitute = проститутка
protagonist = главный герой
proven = доказанный
provided = при условии
proximity = близость
psychic = экстрасенс
publicise = оглашать
puppy = щенок
purposeful = целеустремленный
put away = убирать
put down = положить
put off = откладывать
put on = надевать
put up with = мириться
qualitative = качественный
quarterly = ежеквартальный
radiate = излучать
radiator = радиатор
radically = радикально
radius = радиус
raspberry = малина
readiness = готовность
real estate = недвижимость
received = полученный
reciprocal = взаимный
recreate = воссоздавать
rectangle = прямоугольник
rector = ректор
rediscover = заново открыть
redo = переделать
refreshment = освежение
refurbish = обновлять
refurbishment = ремонт
reinforcements = подкрепление
reliability = надежность
remit = круг обязанностей
renewable = возобновляемый
renovate = ремонтировать
renovation = ремонт
renowned = знаменитый
residual = остаточный
respected = уважаемый
restructuring = реструктуризация
revoke = аннулировать
revolt = восстание
rewarding = вознаграждающий
riddle = загадка
rigorous = строгий
rite = обряд
robust = крепкий
rule out = исключать
rupture = разрыв
safeguard = защита
sailing = парусный спорт
sandal = сандалия
sanitary = санитарный
Saudi = саудовец
Saudi Arabia = Саудовская Аравия
saviour = спаситель
scenery = пейзаж
scientifically = научно
scold = ругать
scout = разведчик
scrub = скраб, тереть
sculpture = скульптура
seating = сидения
second-hand = подержанный
sect = секта
seeker = искатель
seizure = приступ
self-government = самоуправление
sell out = распродавать
selling = продажа
sender = отправитель
sensational = сенсационный
sensor = датчик
sequential = последовательный
serenity = безмятежность
seriousness = серьезность
sermon = проповедь
setback = неудача
setup = установка
sharing = совместное использование
shark = акула
sheath = ножны
shipping = доставка
shipyard = верфь
shooting = стрельба
short-term = краткосрочный
show off = хвастаться
showcase = витрина
shuffle = перемешивать
shut up = замолчи
side-effect = побочный эффект
signing = подписание
simplification = упрощение
simplify = упрощать
simulation = моделирование
simultaneous = одновременный
sincerity = искренность
singing = пение
singular = единственный
sister-in-law = невестка
skinny = худой
slander = клевета
slaughter = убой
slavery = рабство
slipper = тапочка
snooker = снукер
so-so = так себе
sober = трезвый
sociable = общительный
solemn = торжественный
solitary = одинокий
solitude = одиночество
son-in-law = зять
sow = сеять
soya = соя
spacious = просторный
sparrow = воробей
speak out = высказываться
speaking = говорение
specialisation = специализация
specialised = специализированный
specificity = специфичность
speck = пятнышко
speedy = быстрый
sperm = сперма
spirits = алкоголь
sponsorship = спонсорство
spontaneously = спонтанно
sporting = спортивный
sporty = спортивный
sprain = растяжение
stand out = выделяться
starvation = голод
starving = умирающий от голода
stately = величественный
stepchild = пасынок/падчерица
stepdaughter = падчерица
stepfather = отчим
stepmother = мачеха
stepson = пасынок
stew = тушеное мясо
stigma = клеймо
stipulate = оговаривать
stock exchange = фондовая биржа
stock market = рынок акций
stormy = штормовой
straddle = оседлать
stronghold = крепость
structured = структурированный
stubborn = упрямый
stupidity = глупость
subdue = подчинять
subordinate = подчиненный
subscribe = подписываться
subscriber = подписчик
subscription = подписка
subsistence = существование
substitution = замена
sufferer = страдалец
suffice = быть достаточным
summons = повестка
sunglasses = солнцезащитные очки
superficial = поверхностный
superfluous = излишний
superiority = превосходство
supernatural = сверхъестественный
surcharge = дополнительная плата
surpass = превосходить
surveillance = наблюдение
susceptible = восприимчивый
sustainability = устойчивость
sustainable = устойчивый
sweatshirt = толстовка
sweaty = потный
swede = швед
Swedish = шведский
sweetcorn = кукуруза
sweetheart = возлюбленный/ая
sweetness = сладость
swimming costume = купальник
Swiss = швейцарский
symbolise = символизировать
synthetic = синтетический
tab = вкладка
table tennis = настольный теннис
taboo = табу
tact = такт
tactical = тактический
take after = быть похожим
take away = забирать
take care = заботиться
take on = брать на себя
take out = вынимать
take over = захватывать
take part = принимать участие
take up = начинать
talented = талантливый
tangible = ощутимый
tasteless = безвкусный
tasty = вкусный
teddy = плюшевый медвежонок
tell off = отчитывать
temporal = временный
tenderness = нежность
termination = прекращение
terminology = терминология
terrace = терраса
terrestrial = земной
testament = завещание
testimonial = рекомендация
thankful = благодарный
theatrical = театральный
thematic = тематический
thence = оттуда
theologian = теолог
theological = теологический
theoretically = теоретически
therapeutic = терапевтический
thermal = тепловой
thickness = толщина
think of = думать о
thinker = мыслитель
threatening = угрожающий
throw away = выбрасывать
timely = своевременный
tint = оттенок
tiredness = усталость
tits = грудь
torment = мучение
totalitarian = тоталитарный
touching = трогательный
tracksuit = спортивный костюм
trafficking = торговля (нелегальная)
trailer = трейлер
traitor = предатель
trajectory = траектория
tramp = бродяга
tranquil = спокойный
transcribe = записывать
transparency = прозрачность
trauma = травма
treatise = трактат
trendy = модный
tribune = трибуна
tributary = приток
trifle = мелочь
trip up = спотыкаться
troll = тролль
trolley = тележка
troublesome = беспокойный
truce = перемирие
tub = ванна
tuna = тунец
Turk = турок
turn over = переворачивать
tutorial = учебное пособие
ukrainian = украинский
unanimous = единогласный
unanimously = единогласно
unavoidable = неизбежный
unchanged = неизменный
underestimate = недооценивать
underlie = лежать в основе
underway = в процессе
undoubted = несомненный
unequivocal = недвусмысленный
unequivocally = однозначно
uneven = неровный
unexpectedly = неожиданно
unfaithful = неверный
unfaithfulness = неверность
unification = объединение
unified = объединенный
uninteresting = неинтересный
unitary = унитарный
unjust = несправедливый
unlimited = неограниченный
unlock = разблокировать
unlucky = неудачный
unmarried = незамужняя/неженатый
unnecessarily = необязательно
unrest = беспорядки
unsuitable = неподходящий
unsure = неуверенный
unthinkable = немыслимый
unveil = раскрывать
upbringing = воспитание
uphill = в гору
uprising = восстание
uranium = уран
usable = пригодный
usefulness = полезность
utensil = утварь
utilisation = использование
utmost = крайний
vacancy = вакансия
vain = тщеславный
validate = подтверждать
validation = проверка
variant = вариант
vat = НДС
vatican = Ватикан
veil = вуаль
veranda = веранда
verification = проверка
vet = ветеринар
veto = вето
vice versa = наоборот
vice-president = вице-президент
vicinity = окрестности
victorious = победоносный
vile = мерзкий
villa = вилла
violin = скрипка
visibility = видимость
visualise = визуализировать
visually = визуально
vodka = водка
void = пустота
wager = ставка
wallpaper = обои
wanted = разыскиваемый
warmly = тепло
wash up = мыть посуду
washroom = уборная
wasp = оса
watch out = осторожно
watermelon = арбуз
weakly = слабо
web page = веб-страница
webpage = веб-страница
wed = жениться
whereabouts = местонахождение
whim = прихоть
whine = ныть
wicked = злой
widower = вдовец
willingly = охотно
withstand = выдерживать
womb = матка
wonderfully = замечательно
woodland = лесная зона
wording = формулировка
work out = тренироваться
worldly = мирской
worn out = изношенный
worsen = ухудшать
wreck = крушение
wrestle = бороться
yoga = йога
